[
  {
    "method": "json",
    "object": {
      "fill_ter": "t_thconc_floor",
      "rows": [
        "    __________-----_    ",
        "    __________-----_    ",
        "           __ -----     ",
        "           __/zzzzz//   ",
        "     //////dd/.....Z/   ",
        "     /;/bb/../....../   ",
        "     '.d,.d,./....../   ",
        "     /T/.l/../..^.../   ",
        "     //////.,/....../   ",
        "     /T/.l/../....../   ",
        "     '.d,.d,.d....../   ",
        "     /;/bb/../w....L/   ",
        "     //////dd////////   ",
        "       /t......d.>/     ",
        "       '..cCCc.d.>/     ",
        "       /m,cCCc,////     ",
        "       /o.cCCc./        ",
        "       'k&...../        ",
        "       ///'//'//        ",
        "                        ",
        "                        ",
        "                        ",
        "                        ",
        "                        "
      ],
      "palettes": [ "secro_minifleshlab_palette" ]
    },
    "om_terrain": [ "mini_fleshresearchlab" ],
    "type": "mapgen"
  },
  {
    "method": "json",
    "object": {
      "fill_ter": "t_thconc_floor",
      "rows": [
        "########################",
        "########################",
        "#######////////#########",
        "#######/.....</#########",
        "#######/.,...</#########",
        "#######/../////#########",
        "#######/../#############",
        "######//dd//############",
        "#####//....//####aaaaaaa",
        "####//t....t//###a*SQ=aa",
        "####/t.,..,.t////aqqq=Ua",
        "####/v..//...d.,.D====@a",
        "####/v..//...d.,.D====ea",
        "####/t.,..,.t////aqqq=Ea",
        "####//t....t//###a*AQ=aa",
        "#####//....//####aaaaaaa",
        "######//dd//############",
        "#######/../##aaaa#######",
        "#######/..//aa*Uaa######",
        "#######/.,..D===Ma######",
        "#######/....D===@a######",
        "#######/////aah?aa######",
        "#############aaaa#######",
        "########################"
      ],
      "palettes": [ "secro_minifleshlab_palette" ],
      "monster": { "S": { "monster": "mon_zedfail_seeker" }, "A": { "monster": "mon_zedbow_kaxix" } },
      "npcs": { "E": { "class": "secronom_scientist1" } }
    },
    "om_terrain": [ "mini_fleshresearchlab_lab" ],
    "type": "mapgen"
  }
]
