[
  {
    "type": "mapgen",
    "method": "json",
    "om_terrain": [ "bunker" ],
    "object": {
      "rows": [
        " ---------------------- ",
        "--                    --",
        "|                      |",
        "|                      |",
        "|                      |",
        "|                      |",
        "|                      |",
        "|      MMMMMMMMMM      |",
        "|      MMMMMMMMMM      |",
        "|      MMMM>>MMMM      |",
        "|      MM,,,,,,MM      |",
        "|      MMMM,,MMMM      |",
        "|      MM,,,,,,MM      |",
        "//*/   MMMM,,MMMM   /*//",
        "I#,/   MM,,,,,,MM   /,#I",
        "I00/   MMMMDDMMMM   /00I",
        "|      MMMM  6MMM      |",
        "=                      +",
        "=                      +",
        "=                      +",
        "=                      +",
        "=                      +",
        "--                    --",
        " --------++++++-------- "
      ],
      "terrain": {
        " ": [ "t_grass", "t_grass", "t_grass", "t_dirt" ],
        "#": "t_floor",
        "*": "t_door_c",
        "+": "t_chaingate_l",
        "=": "t_chaingate_o",
        ",": "t_floor",
        "-": "t_chainfence_h",
        "/": "t_concrete_wall",
        "0": "t_window",
        "6": "t_card_military",
        ">": "t_stairs_down",
        "D": "t_door_metal_locked",
        "I": "t_ballistic_glass",
        "M": "t_wall_metal",
        "|": "t_chainfence_v"
      },
      "furniture": { "#": "f_table" },
      "place_monster": [
        { "monster": "mon_turret_rifle", "x": 9, "y": 10 },
        { "monster": "mon_turret_rifle", "x": 14, "y": 10 },
        { "monster": "mon_turret_rifle", "x": 9, "y": 12 },
        { "monster": "mon_turret_rifle", "x": 14, "y": 12 },
        { "monster": "mon_turret_rifle", "x": 9, "y": 14 },
        { "monster": "mon_turret_rifle", "x": 14, "y": 14 },
        { "group": "GROUP_ZOMBIE_SUPER_SOLDIER_RANDOM", "x": 18, "y": 14 },
        { "group": "GROUP_ZOMBIE_SUPER_SOLDIER_RANDOM", "x": 20, "y": 21 },
        { "group": "GROUP_ZOMBIE_SUPER_SOLDIER_RANDOM", "x": 21, "y": 16 },
        { "monster": "mon_zombie_failed_weapon", "x": 2, "y": 10 },
        { "monster": "mon_zombie_failed_weapon", "x": 12, "y": 4 }
      ],
      "place_vehicles": [ { "vehicle": "humvee_tow", "x": 8, "y": 18, "rotation": 30, "chance": 100, "fuel": 10, "status": 1 } ]
    }
  },
  {
    "type": "mapgen",
    "method": "json",
    "om_terrain": [ "mil_base_5e" ],
    "weight": 250,
    "object": {
      "fill_ter": "t_thconc_floor",
      "rows": [
        "                        ",
        "                        ",
        "                        ",
        "  XXXXXXXXXXXXXXXXXXXXXX",
        "  X                     ",
        "  X                     ",
        "  X  sssssssssssssssssss",
        "  X  sssssssssssssssssss",
        "  X  ss/////////////////",
        "  X  ss/C.C]u.u]u.u]u.u]",
        "  X  ss/C.C]u.u]u.u]u.u]",
        "  X  ss/C.C]u.u]u.u]u.u]",
        "  X  ss/C.C]u.u]u.u]u.u]",
        "  X  ss/](]]])]]])]]])]]",
        "  X  ss/................",
        "  X  ss/uuuuu.uuuuu.uuuu",
        "  X  ss/////////////////",
        "  X  ss/th..$/uuuu$$/uuu",
        "  X  ss/###..D......d...",
        "  X  ssg###..5$$..[[/u..",
        "  X  ss/th..$///ggg//u..",
        "  X  ss/`....$/[.i.[/u..",
        "  X  ss/OO...Y/[...[/l.e",
        "  XXXGX///gz///w/d/w////"
      ],
      "palettes": [ "mil_base_palette" ],
      "items": {
        "t": [ { "item": "trash_cart", "chance": 75, "repeat": [ 1, 10 ] } ],
        "#": [ { "item": "SUS_office_desk", "chance": 10, "repeat": [ 1, 2 ] } ],
        "$": [ { "item": "SUS_office_filing_cabinet", "chance": 50, "repeat": [ 1, 5 ] } ],
        "O": [ { "item": "mil_base_books", "chance": 30, "repeat": [ 1, 5 ] } ],
        "Y": [ { "item": "mil_base_coats", "chance": 25, "repeat": [ 1, 2 ] } ]
      },
      "monster": { "i": { "monster": "mon_zombie_soldier", "chance": 30 } },
      "place_monster": [
        { "monster": "mon_zombie_bio_dormant_unarmed", "x": 8, "y": 14 },
        { "monster": "mon_zombie_bio_dormant_unarmed", "x": 13, "y": 15 },
        { "monster": "mon_zombie_bio_dormant_unarmed", "x": 9, "y": 10 },
        { "monster": "mon_zombie_bio_dormant_unarmed", "x": 22, "y": 14 }
      ],
      "place_loot": [
        { "item": "arc_laser_rifle", "x": 8, "y": 9, "chance": 75, "repeat": 5 },
        { "item": "krx_laser_lmg", "x": 8, "y": 10, "chance": 75, "repeat": 3 },
        { "item": "mx_laser_sniper", "x": 8, "y": 11, "chance": 75, "repeat": 3 },
        { "item": "mk_ionic_cannon", "x": 8, "y": 12, "chance": 75, "repeat": 1 },
        { "item": "hmil_armor", "x": 10, "y": 9, "chance": 75, "repeat": 3 },
        { "item": "mil_armor", "x": 10, "y": 9, "chance": 75, "repeat": 2 },
        { "item": "lmil_armor", "x": 10, "y": 9, "chance": 75, "repeat": 1 },
        { "item": "adv_UPS_off", "x": 10, "y": 10, "chance": 75, "repeat": 1 },
        { "item": "plut_cell", "x": 10, "y": 10, "chance": 75, "repeat": 5 },
        { "item": "medium_atomic_battery_cell", "x": 10, "y": 11, "chance": 75, "repeat": 10 },
        { "item": "plasma", "x": 10, "y": 12, "chance": 75, "repeat": 2 },
        { "item": "m4a1", "x": 12, "y": [ 9, 11 ], "magazine": 100, "chance": 75, "repeat": 30 },
        { "item": "m27iar", "x": 12, "y": 9, "magazine": 100, "chance": 75, "repeat": 8 },
        { "item": "m16a4", "x": 12, "y": 9, "magazine": 100, "chance": 75, "repeat": 2 },
        { "item": "stanag30", "x": 12, "y": 12, "chance": 75, "repeat": 80 },
        { "item": "stanag50", "x": 12, "y": 12, "chance": 75, "repeat": 20 },
        { "item": "556", "x": 14, "y": [ 9, 12 ], "chance": 75, "repeat": 150 },
        { "item": "m4a1", "x": 16, "y": [ 9, 11 ], "magazine": 100, "chance": 75, "repeat": 36 },
        { "item": "stanag30", "x": 16, "y": 12, "chance": 75, "repeat": 100 },
        { "item": "556", "x": 18, "y": [ 9, 12 ], "chance": 75, "repeat": 150 },
        { "item": "m249", "x": 20, "y": 9, "chance": 75, "repeat": 6 },
        { "item": "m240", "x": 20, "y": 9, "chance": 75, "repeat": 4 },
        { "item": "m1014", "x": 20, "y": 10, "chance": 75, "repeat": 10 },
        { "item": "mossberg_590", "x": 20, "y": 10, "chance": 75, "repeat": 8 },
        { "item": "m2010", "x": 20, "y": 11, "magazine": 100, "chance": 75, "repeat": 2 },
        { "item": "m110a1", "x": 20, "y": 11, "magazine": 100, "chance": 75, "repeat": 8 },
        { "item": "m2010mag", "x": 20, "y": 12, "chance": 75, "repeat": 10 },
        { "item": "hk417mag_20rd", "x": 20, "y": 12, "chance": 75, "repeat": 16 },
        { "item": "hk417mag_10rd", "x": 20, "y": 12, "chance": 75, "repeat": 8 },
        { "item": "300_winmag", "x": 22, "y": 12, "chance": 75, "repeat": 10 },
        { "item": "belt223", "x": 22, "y": 9, "chance": 75, "repeat": 3 },
        { "item": "belt308", "x": 22, "y": 9, "chance": 75, "repeat": 2 },
        { "item": "shot_00", "x": 22, "y": 10, "chance": 75, "repeat": 10 },
        { "item": "shot_slug", "x": 22, "y": 10, "chance": 75, "repeat": 5 },
        { "item": "shot_beanbag", "x": 22, "y": 10, "chance": 75, "repeat": 3 },
        { "item": "shot_he", "x": 22, "y": 10, "chance": 75, "repeat": 5 },
        { "item": "shot_flechette", "x": 22, "y": 10, "chance": 75, "repeat": 5 },
        { "item": "762_51_incendiary", "x": 22, "y": 11, "chance": 75, "repeat": 5 },
        { "item": "762_51", "x": 22, "y": [ 11, 12 ], "chance": 75, "repeat": 30 },
        { "item": "shoulder_strap", "x": [ 8, 9 ], "y": 15, "chance": 75, "repeat": 100 },
        { "item": "holo_sight", "x": 10, "y": 15, "chance": 75, "repeat": 50 },
        { "item": "acog_scope", "x": 11, "y": 15, "chance": 75, "repeat": 30 },
        { "item": "red_dot_sight", "x": 12, "y": 15, "chance": 75, "repeat": 20 },
        { "item": "goggles_ir", "x": [ 14, 16 ], "y": 15, "chance": 75, "repeat": 50 },
        { "item": "goggles_nv", "x": [ 17, 18 ], "y": 15, "chance": 75, "repeat": 40 },
        { "item": "knife_combat", "x": [ 22, 23 ], "y": 15, "chance": 75, "repeat": 100 },
        { "item": "holster", "x": [ 20, 21 ], "y": 15, "chance": 75, "repeat": 100 }
      ]
    }
  },
  {
    "type": "mapgen",
    "method": "json",
    "om_terrain": [ "necropolis_c_2" ],
    "weight": 250,
    "object": {
      "fill_ter": "t_floor",
      "rows": [
        "|---|...................",
        "|r r|...................",
        "|-+-|--|................",
        "    @@d|................",
        "    @@ |................",
        " h     |................",
        "kkk   o|................",
        "-------|.|--------------",
        ".........|rrrrrrrrrrrrrr",
        "|-|-|....|r             ",
        "|r|r|--|.|r  ccc        ",
        "|+|+|@@|-|r  ccc    G   ",
        "       |t|r             ",
        "       + |-------|     |",
        "       |S|.......|    5|",
        "|+|+|@@|-|-------|-===-|",
        "|r|r|--|.|rrrrrrr|    6|",
        "|-|-|....|r      +  G   ",
        "|r|r|--|.|r rrrr |  h   ",
        "|+|+|@@|-|r rrrr |k6kkk|",
        "       |t|r      |!!!!!|",
        "       + |rGrrrr |     |",
        "       |S|r rrrr v     |",
        "|+|+|@@|-|r      v     |"
      ],
      "palettes": [ "necropolis_b2" ],
      "terrain": { "R": "t_hole" },
      "place_loot": [
        { "group": "mags_milspec", "x": [ 12, 15 ], "y": 18, "chance": 30, "repeat": 5 },
        { "item": "medium_atomic_battery_cell", "x": [ 12, 15 ], "y": 18, "chance": 30, "repeat": 5 },
        { "item": "plasma", "x": [ 12, 15 ], "y": 18, "chance": 10 },
        { "group": "ammo_milspec", "x": [ 12, 15 ], "y": 19, "chance": 50, "repeat": 5 },
        { "group": "mil_food_nodrugs", "x": [ 12, 15 ], "y": 21, "chance": 50, "repeat": 5 },
        { "group": "army_personal_locker", "x": [ 12, 15 ], "y": 22, "chance": 50, "repeat": 10 }
      ],
      "place_monsters": [
        { "monster": "GROUP_NECROPOLIS_VAULT2", "x": [ 1, 22 ], "y": [ 1, 6 ], "density": 0.1 },
        { "monster": "GROUP_NECROPOLIS_VAULT2", "x": [ 1, 8 ], "y": [ 6, 22 ], "density": 0.1 }
      ],
      "place_monster": [
        { "group": "GROUP_ZOMBIE_SUPER_SOLDIER_RANDOM", "x": 11, "y": 17 },
        { "group": "GROUP_ZOMBIE_SUPER_SOLDIER_RANDOM", "x": 16, "y": 20 },
        { "group": "GROUP_ZOMBIE_SUPER_SOLDIER_RANDOM", "x": 20, "y": 18 },
        { "group": "GROUP_ZOMBIE_SUPER_SOLDIER_RANDOM", "x": 23, "y": 17 }
      ]
    }
  }
]
