[
  {
    "type": "mapgen",
    "method": "json",
    "om_terrain": [ "field_highway_youkai" ],
    "weight": 1000,
    "object": {
      "rows": [
        ",,,,,,.,,,,.,,,,,,,.,,,,",
        ",,,.,,,,.,,,,.,..,,,,,,,",
        ",,,,,,,..,,,,,,,,..,,,,.",
        ",,,,,,,,,,,,,,..,,,,,,,,",
        ",,,,,,,.,,,,..,,,,..,,,,",
        ",,,..,,,,,,,,,,,..,,,,..",
        ",,,,,,,,,,..,,,,.,,,,,,,",
        ",,,..,,,,,,,,..,,,,,,,,.",
        ",,,,,,,..,,,,.,,,,,,,,..",
        ",,,..,,,,,,,,,,,,,,,,,,.",
        "..,,,,,,,,.,,,,.,,,,,,,.",
        ",,,,,,,,,,,,,,,,,,.,,,,.",
        ",,,.,,,,,,,,,,,,,,,,,,,.",
        ",,,..,,,,,,,,..,,,,,,,,.",
        ",,,,..,,,,..,,,,..,,,,..",
        ",,,.,,,,,,,,,,,,,,,.,,,,",
        ",,,,,,,..,,,,.,,,,.,,,,.",
        ",,,..,,,,.,,,,..,,,,,,,,",
        ",,,..,,,,,,,,,,,,..,,,,.",
        "..,,,,..,,,,,,,,,,,.,,,,",
        ",,,..,..,,,,.,..,,,,,,,.",
        ",,,,,,.,,,,.,,,,,,,,,,,.",
        ",,,..,,,,,,,,,,,,,,,,,,.",
        ",,,.,,,,.,,,,,,,,,,,,,,,"
      ],
      "terrain": { ",": "t_grass", ".": "t_dirt" },
      "place_monsters": [ { "monster": "GROUP_YOUKAI_THUGS", "x": [ 4, 16 ], "y": [ 4, 16 ], "density": 0.1 } ]
    }
  },
  {
    "type": "mapgen",
    "method": "json",
    "om_terrain": [ "pond_field" ],
    "weight": 30,
    "object": {
      "fill_ter": "t_dirt",
      "rows": [
        "                        ",
        "                        ",
        "     ????????????????   ",
        "   ???????????????????  ",
        "   ?**]]]]]*]***]]]]??  ",
        "  ???**************]??  ",
        "  ???*************]]??  ",
        "  ????***[[[*******]??  ",
        "  ???***[[[[[[[[**]]??  ",
        "  ???***[[[[[[[[**]]??  ",
        "  ???***[[[~~~[[**]]??  ",
        "  ??****[[[~~~[[***]??  ",
        "  ??]***[[~~~~[[***]??  ",
        "  ??]***[[~~~~[[**]]??  ",
        "  ??]***[[~[[[[[**]]??  ",
        "  ??]***[[[[[[[[**]]??  ",
        "  ??]*****[[******]]??  ",
        "  ??]**************]??  ",
        "  ??]**************]??  ",
        "  ????]??]]]]]]]]]]]??  ",
        "  ????????]]]????????   ",
        "  ?????????????????     ",
        "                        ",
        "                        "
      ],
      "set": [
        { "point": "furniture", "id": "f_rubble_rock", "x": [ 1, 22 ], "y": [ 1, 22 ], "chance": 8, "repeat": [ 1, 5 ] },
        {
          "point": "furniture",
          "id": "f_boulder_small",
          "x": [ 1, 22 ],
          "y": [ 1, 22 ],
          "chance": 8,
          "repeat": [ 1, 5 ]
        },
        {
          "point": "furniture",
          "id": "f_boulder_medium",
          "x": [ 1, 22 ],
          "y": [ 1, 22 ],
          "chance": 8,
          "repeat": [ 1, 5 ]
        },
        {
          "point": "furniture",
          "id": "f_boulder_large",
          "x": [ 1, 22 ],
          "y": [ 1, 22 ],
          "chance": 8,
          "repeat": [ 1, 5 ]
        }
      ],
      "terrain": {
        " ": [
          "t_water_sh",
          "t_dirt",
          "t_dirt",
          "t_dirt",
          "t_dirt",
          "t_dirt",
          "t_dirt",
          "t_dirt",
          "t_grass",
          "t_grass",
          "t_grass",
          "t_grass",
          "t_grass",
          "t_grass",
          "t_grass",
          "t_grass",
          "t_grass",
          "t_grass",
          "t_grass",
          "t_grass",
          "t_underbrush",
          "t_underbrush"
        ],
        "*": "t_water_sh",
        "?": [
          "t_water_sh",
          "t_water_sh",
          "t_dirt",
          "t_dirt",
          "t_dirt",
          "t_dirt",
          "t_dirt",
          "t_dirt",
          "t_dirt",
          "t_grass",
          "t_grass",
          "t_grass",
          "t_grass",
          "t_grass",
          "t_grass",
          "t_grass",
          "t_grass",
          "t_grass",
          "t_grass",
          "t_grass",
          "t_grass",
          "t_grass",
          "t_shrub",
          "t_tree"
        ],
        "[": [ "t_water_dp", "t_water_dp", "t_water_sh", "t_water_sh", "t_water_sh" ],
        "]": [ "t_water_sh", "t_water_sh", "t_water_sh", "t_water_sh", "t_water_sh", "t_water_sh", "t_dirt", "t_grass" ],
        "~": "t_water_dp"
      },
      "place_monster": [
        { "monster": "mon_kappa_engineer", "x": [ 3, 20 ], "y": [ 3, 20 ], "chance": 80, "repeat": [ 2, 2 ] },
        { "monster": "mon_kappabot", "x": 3, "y": 5, "chance": 80 }
      ]
    }
  },
  {
    "type": "mapgen",
    "method": "json",
    "om_terrain": [ "pond_forest" ],
    "weight": 30,
    "object": {
      "fill_ter": "t_dirt",
      "rows": [
        "                        ",
        "                        ",
        "     ????????????????   ",
        "   ???????????????????  ",
        "   ?**]]]]]*]***]]]]??  ",
        "  ???**************]??  ",
        "  ???*************]]??  ",
        "  ????***[[[*******]??  ",
        "  ???***[[[[[[[[**]]??  ",
        "  ???***[[[[[[[[**]]??  ",
        "  ???***[[[~~~[[**]]??  ",
        "  ??****[[[~~~[[***]??  ",
        "  ??]***[[~~~~[[***]??  ",
        "  ??]***[[~~~~[[**]]??  ",
        "  ??]***[[~[[[[[**]]??  ",
        "  ??]***[[[[[[[[**]]??  ",
        "  ??]*****[[******]]??  ",
        "  ??]**************]??  ",
        "  ??]**************]??  ",
        "  ????]??]]]]]]]]]]]??  ",
        "  ????????]]]????????   ",
        "  ?????????????????     ",
        "                        ",
        "                        "
      ],
      "set": [
        { "point": "furniture", "id": "f_rubble_rock", "x": [ 1, 22 ], "y": [ 1, 22 ], "chance": 8, "repeat": [ 1, 5 ] },
        {
          "point": "furniture",
          "id": "f_boulder_small",
          "x": [ 1, 22 ],
          "y": [ 1, 22 ],
          "chance": 8,
          "repeat": [ 1, 5 ]
        },
        {
          "point": "furniture",
          "id": "f_boulder_medium",
          "x": [ 1, 22 ],
          "y": [ 1, 22 ],
          "chance": 8,
          "repeat": [ 1, 5 ]
        },
        {
          "point": "furniture",
          "id": "f_boulder_large",
          "x": [ 1, 22 ],
          "y": [ 1, 22 ],
          "chance": 8,
          "repeat": [ 1, 5 ]
        }
      ],
      "terrain": {
        " ": [
          "t_dirt",
          "t_dirt",
          "t_dirt",
          "t_grass",
          "t_grass",
          "t_grass",
          "t_shrub",
          "t_tree_young",
          "t_tree_young",
          "t_tree",
          "t_tree"
        ],
        "*": "t_water_sh",
        "?": [
          "t_water_sh",
          "t_water_sh",
          "t_water_sh",
          "t_dirt",
          "t_dirt",
          "t_dirt",
          "t_dirt",
          "t_dirt",
          "t_grass",
          "t_grass",
          "t_grass",
          "t_grass",
          "t_grass",
          "t_grass",
          "t_shrub",
          "t_shrub",
          "t_tree_young",
          "t_tree",
          "t_tree",
          "t_tree_willow"
        ],
        "[": [ "t_water_dp", "t_water_dp", "t_water_sh", "t_water_sh", "t_water_sh" ],
        "]": [
          "t_water_sh",
          "t_water_sh",
          "t_water_sh",
          "t_water_sh",
          "t_water_sh",
          "t_water_sh",
          "t_water_sh",
          "t_water_sh",
          "t_dirt",
          "t_grass"
        ],
        "~": "t_water_dp"
      },
      "place_monster": [
        { "monster": "mon_kappa_engineer", "x": [ 3, 20 ], "y": [ 3, 20 ], "chance": 80, "repeat": [ 2, 2 ] },
        { "monster": "mon_kappabot", "x": 3, "y": 5, "chance": 80 }
      ]
    }
  },
  {
    "type": "mapgen",
    "method": "json",
    "om_terrain": [ "pond_swamp" ],
    "weight": 30,
    "object": {
      "fill_ter": "t_dirt",
      "rows": [
        "                        ",
        "                        ",
        "     ????????????????   ",
        "   ???????????????????  ",
        "   ?**]]]]]*]***]]]]??  ",
        "  ???**************]??  ",
        "  ???*************]]??  ",
        "  ????***[[[*******]??  ",
        "  ???***[[[[[[[[**]]??  ",
        "  ???***[[[[[[[[**]]??  ",
        "  ???***[[[~~~[[**]]??  ",
        "  ??****[[[~~~[[***]??  ",
        "  ??]***[[~~~~[[***]??  ",
        "  ??]***[[~~~~[[**]]??  ",
        "  ??]***[[~[[[[[**]]??  ",
        "  ??]***[[[[[[[[**]]??  ",
        "  ??]*****[[******]]??  ",
        "  ??]**************]??  ",
        "  ??]**************]??  ",
        "  ????]??]]]]]]]]]]]??  ",
        "  ????????]]]????????   ",
        "  ?????????????????     ",
        "                        ",
        "                        "
      ],
      "set": [
        { "point": "furniture", "id": "f_rubble_rock", "x": [ 1, 22 ], "y": [ 1, 22 ], "chance": 8, "repeat": [ 1, 5 ] },
        {
          "point": "furniture",
          "id": "f_boulder_small",
          "x": [ 1, 22 ],
          "y": [ 1, 22 ],
          "chance": 8,
          "repeat": [ 1, 5 ]
        },
        {
          "point": "furniture",
          "id": "f_boulder_medium",
          "x": [ 1, 22 ],
          "y": [ 1, 22 ],
          "chance": 8,
          "repeat": [ 1, 5 ]
        },
        {
          "point": "furniture",
          "id": "f_boulder_large",
          "x": [ 1, 22 ],
          "y": [ 1, 22 ],
          "chance": 8,
          "repeat": [ 1, 5 ]
        },
        { "point": "furniture", "id": "f_cattails", "x": [ 1, 22 ], "y": [ 1, 22 ], "chance": 3, "repeat": [ 1, 5 ] },
        { "point": "furniture", "id": "f_cattails", "x": [ 1, 22 ], "y": [ 1, 22 ], "chance": 3, "repeat": [ 1, 5 ] }
      ],
      "terrain": {
        " ": [
          "t_swater_dp",
          "t_swater_dp",
          "t_swater_sh",
          "t_swater_sh",
          "t_swater_sh",
          "t_dirt",
          "t_dirt",
          "t_dirt",
          "t_dirt",
          "t_grass",
          "t_grass",
          "t_grass",
          "t_grass",
          "t_grass",
          "t_grass",
          "t_shrub",
          "t_underbrush",
          "t_tree_young",
          "t_tree",
          "t_tree_willow"
        ],
        "*": [
          "t_swater_sh",
          "t_swater_sh",
          "t_swater_sh",
          "t_swater_sh",
          "t_swater_sh",
          "t_swater_sh",
          "t_swater_sh",
          "t_swater_sh",
          "t_dirt",
          "t_grass",
          "t_underbrush",
          "t_tree_willow"
        ],
        "?": [
          "t_swater_sh",
          "t_swater_sh",
          "t_swater_sh",
          "t_dirt",
          "t_dirt",
          "t_dirt",
          "t_dirt",
          "t_dirt",
          "t_grass",
          "t_grass",
          "t_grass",
          "t_grass",
          "t_grass",
          "t_grass",
          "t_shrub",
          "t_tree_young",
          "t_tree",
          "t_tree_willow"
        ],
        "[": [
          "t_swater_dp",
          "t_swater_dp",
          "t_swater_dp",
          "t_swater_dp",
          "t_swater_sh",
          "t_swater_sh",
          "t_swater_sh",
          "t_swater_sh",
          "t_underbrush"
        ],
        "]": [
          "t_swater_sh",
          "t_swater_sh",
          "t_swater_sh",
          "t_swater_sh",
          "t_swater_sh",
          "t_swater_sh",
          "t_swater_sh",
          "t_swater_sh",
          "t_dirt",
          "t_grass",
          "t_tree_willow"
        ],
        "~": [
          "t_swater_dp",
          "t_swater_dp",
          "t_swater_dp",
          "t_swater_dp",
          "t_swater_dp",
          "t_swater_dp",
          "t_swater_dp",
          "t_swater_dp",
          "t_dirt",
          "t_grass",
          "t_underbrush",
          "t_tree_willow"
        ]
      },
      "place_monster": [
        { "monster": "mon_kappa_engineer", "x": [ 3, 20 ], "y": [ 3, 20 ], "chance": 80, "repeat": [ 2, 2 ] },
        { "monster": "mon_kappabot", "x": 3, "y": 5, "chance": 80 }
      ]
    }
  }
]
