[
  {
    "//": "TODO spawn for q and maybe more",
    "type": "mapgen",
    "method": "json",
    "om_terrain": [ [ "fk_base_1", "fk_base_2" ] ],
    "weight": 100,
    "object": {
      "faction_owner": [
        { "id": "flame_knuckle", "x": [ 0, 23 ], "y": [ 0, 23 ] },
        { "id": "flame_knuckle", "x": [ 24, 47 ], "y": [ 0, 23 ] }
      ],
      "predecessor_mapgen": "forest",
      "rows": [
        "          ,                                     ",
        "          ,     ##1#####1####1##                ",
        "          ,     #qqqq#dd_CCCCdd#                ",
        "          ,     1____#6_______61                ",
        " ,,,,,,,,,,     #q__B#dd_____dd#                ",
        " ,        ,     #w__B#6________#                ",
        " ,        ,     1w__B#dd_d_d_d_1                ",
        " ,        ,     #w__q#___d6d6d_#                ",
        " ,    ##o#+#o######x##+#######+#                ",
        " ,    #______'CC#qq_u#__#bb~R#u#                ",
        " ,    #_________#q___#__+~~~R###                ",
        " ,    #_t==t==t_x____x__#s4~v#u#                ",
        " ,    o_=======_#'__u#__######+#                ",
        " ,    #_=======_#___u#__wwwwww_#                ",
        " ,    #_P==P==P_#q__u#_________#                ",
        " ,    #_________######_wwwwwww_1                ",
        " ,    o_________#r#_9#_________#                ",
        " ,    #$$$?_---_#_#+##_wwwwwww_#                ",
        " ,,,, #555$_e-e_+___u#_________#                ",
        " ,  , #555$_---_#_#+##_wwwwwww_1                ",
        " ,  , #555$_'___#r#_9#____'____#                ",
        "|+| , ##o####o#+#######1####1###                ",
        "|T| ,        ,                                  ",
        "||| ,,,,,,,,,,                                  "
      ],
      "palettes": [ "more_npc_palette" ],
      "place_zones": [
        { "type": "NPC_INVESTIGATE_ONLY", "faction": "flame_knuckle", "x": [ 16, 23 ], "y": [ 1, 15 ] },
        { "type": "NPC_INVESTIGATE_ONLY", "faction": "flame_knuckle", "x": [ 24, 31 ], "y": [ 1, 21 ] }
      ],
      "terrain": {
        "v": "t_floor",
        "_": "t_floor",
        "5": "t_floor",
        "C": "t_floor",
        "q": "t_floor",
        "w": "t_floor",
        "r": "t_floor",
        "9": "t_floor",
        "u": "t_floor",
        "B": "t_floor",
        "d": "t_floor",
        "6": "t_floor",
        "R": "t_floor",
        "|": "t_wall_log",
        ",": "t_dirt",
        "E": "t_carpet_green",
        "t": "t_carpet_green",
        "P": "t_carpet_green",
        "-": "t_carpet_red",
        "e": "t_carpet_red",
        "b": "t_carpet_purple",
        "s": "t_carpet_purple",
        "4": "t_carpet_purple",
        "T": "t_pit_covered"
      },
      "items": {
        "q": [
          { "item": "pasta", "chance": 80, "repeat": [ 2, 8 ] },
          { "item": "kitchen", "chance": 50, "repeat": [ 1, 3 ] },
          { "item": "snacks", "chance": 25, "repeat": [ 1, 3 ] }
        ]
      },
      "place_item": [ { "item": "atomic_lamp", "x": 25, "y": 11 } ],
      "place_npcs": [
        { "class": "flame_knuckle_apprentice", "x": 20, "y": 3 },
        { "class": "flame_knuckle_master", "x": 23, "y": 9 },
        { "class": "flame_knuckle_elite", "x": 11, "y": 10 },
        { "class": "flame_knuckle_apprentice", "x": 8, "y": 11 },
        { "class": "flame_knuckle_apprentice", "x": 11, "y": 11 },
        { "class": "flame_knuckle_master", "x": 23, "y": 11 },
        { "class": "flame_knuckle_apprentice_door", "x": 15, "y": 12 },
        { "class": "flame_knuckle_apprentice", "x": 8, "y": 13 },
        { "class": "flame_knuckle_apprentice", "x": 14, "y": 13 },
        { "class": "flame_knuckle_apprentice", "x": 22, "y": 13 },
        { "class": "flame_knuckle_apprentice", "x": 18, "y": 14 },
        { "class": "flame_knuckle_elite", "x": 11, "y": 17 },
        { "class": "flame_knuckle_apprentice", "x": 9, "y": 18 },
        { "class": "flame_knuckle_apprentice", "x": 7, "y": 20 },
        { "class": "flame_knuckle_elite", "x": 20, "y": 20 },
        { "class": "flame_knuckle_apprentice", "x": 30, "y": 20 }
      ]
    }
  },
  {
    "//": "TODO edit to make roof cooler",
    "type": "mapgen",
    "method": "json",
    "om_terrain": [ [ "fk_base_roof_1", "fk_base_roof_2" ] ],
    "object": {
      "fill_ter": "t_open_air",
      "rows": [
        "                                                ",
        "                ................                ",
        "                ................                ",
        "                ................                ",
        "                ................                ",
        "                ................                ",
        "                ................                ",
        "                ................                ",
        "      ..........................                ",
        "      ..........................                ",
        "      ..........................                ",
        "      ..........................                ",
        "      ..........................                ",
        "      ..........................                ",
        "      ..........................                ",
        "      ..........................                ",
        "      ..........................                ",
        "      ..........................                ",
        "      ..........................                ",
        "      ..........................                ",
        "      ..........................                ",
        "      ..........................                ",
        "...   ..........................                ",
        "...                                             ",
        "...                                             "
      ],
      "palettes": [ "roof_palette" ]
    }
  },
  {
    "type": "mapgen",
    "method": "json",
    "om_terrain": "fk_base_stash",
    "weight": 250,
    "object": {
      "fill_ter": "t_rock",
      "rows": [
        " |---|                  ",
        "|-126|                  ",
        "|<...|                  ",
        "|-345|                  ",
        " |---|                  ",
        "                        ",
        "                        ",
        "                        ",
        "                        ",
        "                        ",
        "                        ",
        "                        ",
        "                        ",
        "                        ",
        "                        ",
        "                        ",
        "                        ",
        "                        ",
        "                        ",
        "                        ",
        "                        ",
        "                        ",
        "                        ",
        "                        "
      ],
      "terrain": { "-": "t_wall", ".": "t_rock_floor", "<": "t_stairs_up", "|": "t_wall" },
      "furniture": { "1": "f_utility_shelf", "2": "f_utility_shelf", "3": "f_utility_shelf", "4": "f_utility_shelf","5": "f_utility_shelf","6": "f_utility_shelf" },
      "loot": {
        "1": { "group": "survivorzed_suits", "chance": 75, "repeat": [ 2, 4 ] },
        "2": { "group": "survivorzed_head", "chance": 75, "repeat": [ 2, 4 ] },
        "3": { "group": "survivorzed_extra", "chance": 75, "repeat": [ 2, 4 ] },
        "4": { "group": "survivorzed_tops", "chance": 75, "repeat": [ 2, 4 ] },
        "5": { "group": "weapons", "chance": 75, "repeat": [ 2, 4 ] },
        "6": { "group": "jewelry_front", "chance": 75, "repeat": [ 8, 16 ] }
      }
    }
  }
]
