[
  {
    "type": "mapgen",
    "om_terrain": [ "morlock_village_corner_a" ],
    "method": "json",
    "weight": 0,
    "object": {
      "fill_ter": "t_rock_floor",
      "rows": [
        "   ###  #############   ",
        " ###################### ",
        " ###################### ",
        "########################",
        "########################",
        "########################",
        "######            ##### ",
        "######            ##### ",
        "######            ######",
        "######            ######",
        "######            ######",
        "######            ######",
        "######            ######",
        "######            ######",
        "######            ######",
        "######            ######",
        " #####            ######",
        " #####            ######",
        "########################",
        "########################",
        "########################",
        " ###################### ",
        " ###################### ",
        "   ############  ####   "
      ],
      "palettes": [ "morlock_village" ]
    }
  },
  {
    "type": "mapgen",
    "om_terrain": [ "morlock_village_corner_a" ],
    "method": "json",
    "weight": 1000,
    "object": {
      "fill_ter": "t_rock_floor",
      "rows": [
        "....#####......#########",
        "...######H....H#########",
        "..#########++P##########",
        ".##########..###########",
        "###########..###########",
        "##########....#######H##",
        "#########H.....yA1A#....",
        "#########......y...#....",
        "#########......yyyy#..##",
        ".H######...............#",
        "..P####................#",
        "..+........<<..........#",
        "..+........<<..........#",
        "..#####........yyyy#..##",
        ".H######H......y...#..##",
        "#########......yA1A#..##",
        "##########...#######..##",
        "###########H####......##",
        "################......##",
        "################..######",
        "################..##====",
        "##############H...##=RC.",
        "################..##=O..",
        "################..##=..."
      ],
      "rotation": 0,
      "palettes": [ "morlock_village" ],
      "terrain": { "P": "t_rock" },
      "signs": { "P": { "signage": "Secret Morlock Village" } },
      "furniture": { "1": "f_sofa", "y": "f_sandbag_half" }
    }
  }
]
