[
  {
    "type": "mapgen",
    "om_terrain": [ "morlock_village_mid_b" ],
    "method": "json",
    "weight": 0,
    "object": {
      "fill_ter": "t_rock_floor",
      "rows": [
        "   #############  ###   ",
        " ###################### ",
        " ###################### ",
        "########################",
        "########################",
        "########################",
        " #####            ######",
        " #####            ######",
        "######            ######",
        "######            ######",
        "######            ######",
        "######            ######",
        "######            ######",
        "######            ######",
        "######            ######",
        "######            ######",
        "######            ##### ",
        "######            ##### ",
        "########################",
        "########################",
        "########################",
        " ###################### ",
        " ###################### ",
        "   ###  #############   "
      ],
      "rotation": [ 0, 3 ],
      "palettes": [ "morlock_village" ],
      "place_nested": [
        { "chunks": [ "morlock_mid_b_ring" ], "x": 0, "y": 0 },
        { "chunks": [ [ "null", 20 ], [ "morlock_mid_core", 80 ] ], "x": 0, "y": 0 }
      ]
    }
  },
  {
    "type": "mapgen",
    "om_terrain": [ "morlock_village_mid_b" ],
    "method": "json",
    "weight": 1000,
    "object": {
      "fill_ter": "t_rock_floor",
      "rows": [
        "################  ######",
        "########################",
        "########################",
        "########################",
        "########################",
        "########################",
        " #######################",
        " #######################",
        "########################",
        "########################",
        "########################",
        "########################",
        "########################",
        "########################",
        "########################",
        "########################",
        "####################### ",
        "####################### ",
        "########################",
        "########################",
        "########################",
        "########################",
        "########################",
        "######  ################"
      ],
      "rotation": [ 0, 3 ],
      "palettes": [ "morlock_village" ],
      "place_nested": [
        { "chunks": [ "morlock_mid_b_ring" ], "x": 0, "y": 0 },
        { "chunks": [ [ "null", 20 ], [ "morlock_mid_core", 80 ] ], "x": 0, "y": 0 }
      ]
    }
  },
  {
    "type": "mapgen",
    "om_terrain": [ "morlock_village_mid_b" ],
    "method": "json",
    "weight": 1000,
    "object": {
      "fill_ter": "t_rock_floor",
      "rows": [
        "################  ######",
        "################..######",
        "##########~~~~~~~#######",
        "######~~~~~~~~~~~~~#####",
        "###~~~~~~~~~~~~~~~######",
        "####~~~~~~~~~~~~~~~#####",
        "   ~~~~~~~~~~~~~~~~~~###",
        " ...~~~~~~~~~~~~~~~~####",
        "#####~~~~~~~~~~~~~######",
        "#######~~~~~~~~#########",
        "########################",
        "########################",
        "########################",
        "########################",
        "########################",
        "##########~~~~~#########",
        "#######~~~~~~~~~~#      ",
        "#####~~~~~~~~~~~~~~     ",
        "###~~~~~~~~~~~~~~~~~~###",
        "####~~~~~~~~~~~~~~~~####",
        "###~~~~~~~~~~~~~~~~#####",
        "######~~~~~~~~~~~#######",
        "######  ##~~~~~~########",
        "######  ################"
      ],
      "rotation": [ 0, 3 ],
      "palettes": [ "morlock_village" ],
      "place_nested": [
        { "chunks": [ "morlock_mid_b_ring" ], "x": 0, "y": 0 },
        { "chunks": [ [ "null", 20 ], [ "morlock_mid_core", 80 ] ], "x": 0, "y": 0 }
      ]
    }
  },
  {
    "type": "mapgen",
    "om_terrain": [ "morlock_village_mid_b" ],
    "method": "json",
    "weight": 1000,
    "object": {
      "fill_ter": "t_rock_floor",
      "rows": [
        "################  ######",
        "################   #####",
        "#################  #####",
        "######  ##########  ####",
        "#####    #######     ###",
        "####       ###       ###",
        " ###                ####",
        " ####               ####",
        "######             #####",
        "######             #####",
        "#####             ######",
        "####               #####",
        "####                ####",
        "#####              #####",
        "#####             ######",
        "####               #####",
        "###                 ### ",
        "####                ### ",
        "####        ###      ###",
        "###       #######    ###",
        "##          ######  ####",
        "###      ###############",
        "#####   ################",
        "######  ################"
      ],
      "rotation": [ 0, 3 ],
      "palettes": [ "morlock_village" ],
      "place_nested": [
        { "chunks": [ "morlock_mid_b_ring" ], "x": 0, "y": 0 },
        { "chunks": [ [ "null", 20 ], [ "morlock_mid_core", 80 ] ], "x": 0, "y": 0 }
      ]
    }
  },
  {
    "type": "mapgen",
    "om_terrain": [ "morlock_village_mid_b" ],
    "method": "json",
    "weight": 1000,
    "object": {
      "fill_ter": "t_rock_floor",
      "rows": [
        "################  ######",
        "###########       ######",
        "######              ####",
        "####                 ###",
        "###                   ##",
        "##                    ##",
        "                      ##",
        "           ##        ###",
        "#         ####       ###",
        "##      ######       ###",
        "##       ######       ##",
        "###       ####        ##",
        "###        ##        ###",
        "###                  ###",
        "##                   ###",
        "##                    ##",
        "##                      ",
        "##                      ",
        "##                    ##",
        "###                  ###",
        "####               #####",
        "#####         ##########",
        "######   ###############",
        "######  ################"
      ],
      "rotation": [ 0, 3 ],
      "palettes": [ "morlock_village" ],
      "place_nested": [
        { "chunks": [ "morlock_mid_b_ring" ], "x": 0, "y": 0 },
        { "chunks": [ [ "null", 20 ], [ "morlock_mid_core", 80 ] ], "x": 0, "y": 0 }
      ]
    }
  },
  {
    "type": "mapgen",
    "om_terrain": [ "morlock_village_mid_b" ],
    "method": "json",
    "weight": 1000,
    "object": {
      "fill_ter": "t_rock_floor",
      "rows": [
        "################  ######",
        "#####,,,##,,,,,,,,#,,,##",
        "##,###,,,,,,##,,,,,,####",
        "##,,,,,,,,,,,,,,,##,,###",
        "###,,,##,,,,,,,,,,,,,,##",
        "##,,#,,,,,,,,,,,,,##,,##",
        "   ,,,,,,,,,,,,,,,,,,,##",
        "  ,,,,,,,,,,,,,,,,,,,###",
        "#,,,,,,,,,,,,,,,,,#,,###",
        "##,#,,,,,,,,,,,,,,#,,,,#",
        "##,,,,,,,,,,,,,,,,,,,###",
        "####,,,,,,,,,,,,,,#,,,##",
        "###,,,,,,,,,,,,,,,##,###",
        "#,,,,,,,,,,,,,,,,,,,,###",
        "##,,#,,,,,,,,,,,,,,,,###",
        "##,,#,,,,,,,,,,,,,##,,##",
        "#,,,,,,,,,,,,,,,,,,,,   ",
        "#,,###,,,,,,,,,,,,,,,   ",
        "##,,,,,,,,,,,,,,###,,,##",
        "##,,,,#,,,##,,,,,,,,,###",
        "##,#,,,,,,,,,,,,,,,#####",
        "##,##,,,,,,,,,###,,,####",
        "#####,   ##,,,,#########",
        "######  ################"
      ],
      "rotation": [ 0, 3 ],
      "palettes": [ "morlock_village" ],
      "terrain": { ",": "t_sand" },
      "place_nested": [
        { "chunks": [ "morlock_mid_b_ring" ], "x": 0, "y": 0 },
        { "chunks": [ [ "null", 20 ], [ "morlock_mid_core", 80 ] ], "x": 0, "y": 0 }
      ]
    }
  },
  {
    "type": "mapgen",
    "om_terrain": [ "morlock_village_mid_b" ],
    "method": "json",
    "weight": 1000,
    "object": {
      "fill_ter": "t_rock_floor",
      "rows": [
        "################  ######",
        "##########,,,,,,,,,,####",
        "######,,,,,,,,,,,,,,####",
        "#####,,,,,,,,,,,,,,#####",
        "###,,,,,,,,,,,,,,,,,,###",
        "#####,,,,,,,,,,,,,,,,###",
        " ,,,,,,,,,,,,,,,,,,#####",
        " ,,,,,,,,,,,,,,,,,,,,###",
        "####,,,,,,,,,,,,,,######",
        "######,,,,,,,,,,########",
        "########,,,,,,,,########",
        "##########,,,,,#########",
        "###########,############",
        "##########,,############",
        "########,,,,,,##########",
        "#####,,,,,,,,,,,########",
        "####,,,,,,,,,,,,,,##### ",
        "######,,,,,,,,,,,###### ",
        "#######,,,,,,,,,########",
        "######,,,,,,,,,,,#######",
        "##########,,,,,#########",
        "########################",
        "########################",
        "######  ################"
      ],
      "rotation": [ 0, 3 ],
      "palettes": [ "morlock_village" ],
      "terrain": { ",": "t_dirt" },
      "place_nested": [
        { "chunks": [ "morlock_mid_b_ring" ], "x": 0, "y": 0 },
        { "chunks": [ [ "null", 20 ], [ "morlock_mid_core", 80 ] ], "x": 0, "y": 0 }
      ]
    }
  },
  {
    "type": "mapgen",
    "om_terrain": [ "morlock_village_mid_b" ],
    "method": "json",
    "weight": 1000,
    "object": {
      "fill_ter": "t_rock_floor",
      "rows": [
        "########################",
        "###~~~~~###########~~~##",
        "##~~~~~~~########~~~~~~#",
        "##~~~~~~~~######~~~~~~~#",
        "##~~~~~~~~#####~~~~~~~##",
        "##~~~~~~~~~~####~~~~~###",
        "#~~~~~~~~~~~###~~~~~~~##",
        "##~~~~~~~###~~~~~~~~~~~#",
        "###~~~~~######~~~~~~~~##",
        "####~~##########~~~~~###",
        "############~~##~#######",
        "###########~~~~~~~~#####",
        "#########~~~~~~~~~~~~###",
        "#########~~~~~~~~~~~~~##",
        "####~~###~~~~~~~~~~~~~##",
        "###~~~~###~~~~~~~~~~~###",
        "##~~~~~~###~~~~~~~~~~###",
        "##~~~~~~~###~~~~~~~#####",
        "###~~~~~~#####~~~~######",
        "####~~~~################",
        "########################",
        "########################",
        "########################",
        "########################"
      ],
      "rotation": [ 0, 3 ],
      "palettes": [ "morlock_village" ],
      "place_nested": [
        { "chunks": [ "morlock_mid_b_ring" ], "x": 0, "y": 0 },
        { "chunks": [ [ "null", 20 ], [ "morlock_mid_core", 80 ] ], "x": 0, "y": 0 }
      ]
    }
  },
  {
    "type": "mapgen",
    "om_terrain": [ "morlock_village_mid_b" ],
    "method": "json",
    "weight": 1000,
    "object": {
      "fill_ter": "t_rock_floor",
      "rows": [
        "###############...######",
        "###############...######",
        "########.......##.######",
        "###.....##.###.##.######",
        "###.##..##.###.##.######",
        "###.##..............####",
        "........##..###.###.####",
        ".###.##.##..###.###....#",
        ".###.##.............##.#",
        ".....##.##.##.##.##.##.#",
        "###.....##.##.##.##....#",
        "###.###.##.......##.##.#",
        "###.###....##.###...##.#",
        "#.......##.##.###......#",
        "#.##.##.##.##....###.###",
        "#.##.##.......##.###.###",
        "#....##.##.##.##........",
        "##......##.##....##.###.",
        "##.###........##.##.###.",
        "##.###.##.###.##.##.....",
        "##.....##.###.......####",
        "##.##.........##########",
        "##.##..#################",
        "##....##################"
      ],
      "rotation": [ 0, 3 ],
      "palettes": [ "morlock_village" ],
      "place_nested": [
        { "chunks": [ "morlock_mid_b_ring" ], "x": 0, "y": 0 },
        { "chunks": [ [ "null", 20 ], [ "morlock_mid_core", 80 ] ], "x": 0, "y": 0 }
      ]
    }
  }
]
