[
  {
    "type": "mapgen",
    "om_terrain": [ "morlock_village_edge_a" ],
    "method": "json",
    "weight": 1000,
    "object": {
      "fill_ter": "t_rock_floor",
      "rows": [
        "########################",
        "########################",
        "########################",
        "########################",
        "########################",
        "########################",
        "########################",
        "########################",
        "########################",
        "########################",
        "########################",
        "########################",
        "########################",
        "########################",
        "########################",
        "########################",
        "......##################",
        "......##################",
        "####..=============#####",
        "####..=&s=&s=&s=&s=#####",
        "====..=+==+==+==+=======",
        ".ll=..............##=Bd.",
        "...+..............H#=B@.",
        "...=############..##=H.."
      ],
      "rotation": 0,
      "palettes": [ "morlock_village" ]
    }
  },
  {
    "type": "mapgen",
    "om_terrain": [ "morlock_village_edge_a" ],
    "method": "json",
    "weight": 1000,
    "object": {
      "fill_ter": "t_rock_floor",
      "rows": [
        "########################",
        "########################",
        "########################",
        "########################",
        "########################",
        "########################",
        "########################",
        "########################",
        "########################",
        "########################",
        "########################",
        "########################",
        "########################",
        "########################",
        "########################",
        "########################",
        "......##################",
        "......##################",
        "####..##################",
        "####..##################",
        "====..##############====",
        "bbN=..............##=Bd.",
        "...+..............##=B@.",
        "...=############..##=H.."
      ],
      "rotation": 0,
      "palettes": [ "morlock_village" ]
    }
  },
  {
    "type": "mapgen",
    "om_terrain": [ "morlock_village_edge_a" ],
    "method": "json",
    "weight": 1000,
    "object": {
      "fill_ter": "t_rock_floor",
      "rows": [
        "########################",
        "########################",
        "########################",
        "########################",
        "########################",
        "########################",
        "########################",
        "########################",
        "########################",
        "########################",
        "########################",
        "########################",
        "########################",
        "########################",
        "########################",
        "########################",
        "..................######",
        "..................######",
        "################..######",
        "################..######",
        "====############..##====",
        "..N=############..##=DD.",
        "...=############..##=c..",
        "...=############..##=H.."
      ],
      "rotation": 0,
      "palettes": [ "morlock_village" ]
    }
  }
]
