[
  {
    "type": "mapgen",
    "om_terrain": [ "morlock_village_sewer" ],
    "method": "json",
    "weight": 1000,
    "object": {
      "fill_ter": "t_sewage",
      "rows": [
        "####,,,,,,,,,,,,,,,,####",
        "####,,,,,,,,,,,,,,,,####",
        "####,,,,,,,,,,,,,,,,####",
        "####,,,,,,,,,,,,,,,,####",
        ",,,,,,,,,,,,,,,,,,,,,,,,",
        ",,,,,,,,,,,,,,,,,,,,,,,,",
        ",,,,,,,,,,,,,,,,,,,,,,,,",
        ",,,,,,,,,,,,,,,,,,,,,,,,",
        ",,,,,,,,##,,,,##,,,,,,,,",
        ",,,,,,,,#......#,,,,,,,,",
        ",,,,,,,,,......,,,,,,,,,",
        ",,,,,,,,,..>>..,,,,,,,,,",
        ",,,,,,,,,..>>..,,,,,,,,,",
        ",,,,,,,,,......,,,,,,,,,",
        ",,,,,,,,#......#,,,,,,,,",
        ",,,,,,,,##,,,,#P,,,,,,,,",
        ",,,,,,,,,,,,,,,,,,,,,,,,",
        ",,,,,,,,,,,,,,,,,,,,,,,,",
        ",,,,,,,,,,,,,,,,,,,,,,,,",
        ",,,,,,,,,,,,,,,,,,,,,,,,",
        "####,,,,,,,,,,,,,,,,####",
        "####,,,,,,,,,,,,,,,,####",
        "####,,,,,,,,,,,,,,,,####",
        "####,,,,,,,,,,,,,,,,####"
      ],
      "rotation": 0,
      "palettes": [ "morlock_village" ],
      "terrain": { "P": "t_rock", ",": "t_sewage" },
      "signs": { "P": { "signage": "Secret Morlock Village" } }
    }
  }
]
