[
  {
    "type": "mapgen",
    "om_terrain": [ "morlock_village_mid_a" ],
    "method": "json",
    "weight": 0,
    "object": {
      "fill_ter": "t_rock_floor",
      "rows": [
        "   ###  #############   ",
        " ###################### ",
        " ###################### ",
        "########################",
        "########################",
        "########################",
        "######            ##### ",
        "######            ##### ",
        "######            ######",
        "######            ######",
        "######            ######",
        "######            ######",
        "######            ######",
        "######            ######",
        "######            ######",
        "######            ######",
        " #####            ######",
        " #####            ######",
        "########################",
        "########################",
        "########################",
        " ###################### ",
        " ###################### ",
        "   ############  ####   "
      ],
      "rotation": [ 0, 3 ],
      "palettes": [ "morlock_village" ],
      "place_nested": [
        { "chunks": [ "morlock_mid_a_ring" ], "x": 0, "y": 0 },
        { "chunks": [ [ "null", 20 ], [ "morlock_mid_core", 80 ] ], "x": 0, "y": 0 }
      ]
    }
  },
  {
    "type": "mapgen",
    "om_terrain": [ "morlock_village_mid_a" ],
    "method": "json",
    "weight": 1000,
    "object": {
      "fill_ter": "t_rock_floor",
      "rows": [
        "######  ################",
        "######  ################",
        "########################",
        "########################",
        "########################",
        "########################",
        "######################  ",
        "######################  ",
        "########################",
        "########################",
        "########################",
        "########################",
        "########################",
        "########################",
        "########################",
        "########################",
        "  ######################",
        "  ######################",
        "########################",
        "########################",
        "########################",
        "########################",
        "###############  #######",
        "###############  #######"
      ],
      "rotation": [ 0, 3 ],
      "palettes": [ "morlock_village" ],
      "place_nested": [
        { "chunks": [ "morlock_mid_a_ring" ], "x": 0, "y": 0 },
        { "chunks": [ [ "null", 20 ], [ "morlock_mid_core", 80 ] ], "x": 0, "y": 0 }
      ]
    }
  },
  {
    "type": "mapgen",
    "om_terrain": [ "morlock_village_mid_a" ],
    "method": "json",
    "weight": 1000,
    "object": {
      "fill_ter": "t_rock_floor",
      "rows": [
        "########################",
        "########################",
        "########################",
        "########################",
        "########################",
        "########################",
        "########################",
        "########################",
        "########################",
        "########################",
        "########################",
        "########################",
        "########################",
        "########################",
        "########################",
        "########################",
        "########################",
        "########################",
        "########################",
        "########################",
        "########################",
        "########################",
        "########################",
        "########################"
      ],
      "rotation": 0,
      "palettes": [ "morlock_village" ],
      "place_terrain": [ { "ter": "t_water_sh", "repeat": [ 20, 50 ], "x": [ 4, 20 ], "y": [ 4, 20 ] } ],
      "place_nested": [
        { "chunks": [ "morlock_mid_a_ring" ], "x": 0, "y": 0 },
        { "chunks": [ [ "null", 20 ], [ "morlock_mid_core", 80 ] ], "x": 0, "y": 0 }
      ]
    }
  },
  {
    "type": "mapgen",
    "om_terrain": [ "morlock_village_mid_a" ],
    "method": "json",
    "weight": 1000,
    "object": {
      "fill_ter": "t_rock_floor",
      "rows": [
        "######  ################",
        "######  ################",
        "########################",
        "########################",
        "#########~~#####~~~#####",
        "####~~##~~~~###~~~~~####",
        "###~~~~~~~~~~~~~~~~~##  ",
        "####~~~~~~~~~~~~~~####  ",
        "#####~~~~~~~~~~~~~~~####",
        "#####~~~~~~~~~~~~~~#####",
        "####~~~~~~~~~~~~~~~~####",
        "####~~~~~~~~~~~~~~######",
        "#####~~~~~~~~~~~~#######",
        "######~~~~~~~~~~~~######",
        "#####~~~~~~~~~~~~~~#####",
        "####~~~~~~~~~~~~~~~~####",
        "  ##~~~~~~~~~~~~~~~~####",
        "  ##~~~~~~~~~~~~~~~~~###",
        "#####~~~~~~~###~~~~~~###",
        "######~~~~######~~~#####",
        "########################",
        "########################",
        "###############  #######",
        "###############  #######"
      ],
      "rotation": [ 0, 3 ],
      "palettes": [ "morlock_village" ],
      "place_nested": [
        { "chunks": [ "morlock_mid_a_ring" ], "x": 0, "y": 0 },
        { "chunks": [ [ "null", 20 ], [ "morlock_mid_core", 80 ] ], "x": 0, "y": 0 }
      ]
    }
  },
  {
    "type": "mapgen",
    "om_terrain": [ "morlock_village_mid_a" ],
    "method": "json",
    "weight": 1000,
    "object": {
      "fill_ter": "t_rock_floor",
      "rows": [
        "######  ##     #########",
        "######  ## ##  #########",
        "######     ##    #######",
        "######            ######",
        "####    ###  ##     ####",
        "##   ## ###  ##     ####",
        "#    ##                 ",
        "# ##              ##    ",
        "# ##     ##       ##  ##",
        "#        ##    ##     ##",
        "##  ##         ##     ##",
        "### ##            ##  ##",
        "###               ##  ##",
        "###   ##        ##   ###",
        "###   ##        ##   ###",
        "##       ##         ####",
        "   ##    ##   ##    ####",
        "   ##         ##     ###",
        "##    ###             ##",
        "####  ##    ###      ###",
        "#####       ###    #####",
        "######           #######",
        "########  #####  #######",
        "###############  #######"
      ],
      "rotation": [ 0, 3 ],
      "palettes": [ "morlock_village" ],
      "place_nested": [
        { "chunks": [ "morlock_mid_a_ring" ], "x": 0, "y": 0 },
        { "chunks": [ [ "null", 20 ], [ "morlock_mid_core", 80 ] ], "x": 0, "y": 0 }
      ]
    }
  },
  {
    "type": "mapgen",
    "om_terrain": [ "morlock_village_mid_a" ],
    "method": "json",
    "weight": 1000,
    "object": {
      "fill_ter": "t_rock_floor",
      "rows": [
        "######  ################",
        "########################",
        "########################",
        "########################",
        "###### ##### ##### #####",
        "####    ###    ##  #####",
        "#####               ### ",
        "######             #### ",
        "#####             ######",
        "####              ######",
        "#####             ######",
        "######             #####",
        "######              ####",
        "#####              #####",
        "####              ######",
        "#####             ######",
        " #####            ######",
        " #####             #####",
        "####       ####    #####",
        "#######  ####### #######",
        "########################",
        "########################",
        "########################",
        "###############  #######"
      ],
      "rotation": [ 0, 3 ],
      "palettes": [ "morlock_village" ],
      "place_nested": [
        { "chunks": [ "morlock_mid_a_ring" ], "x": 0, "y": 0 },
        { "chunks": [ [ "null", 20 ], [ "morlock_mid_core", 80 ] ], "x": 0, "y": 0 }
      ]
    }
  },
  {
    "type": "mapgen",
    "om_terrain": [ "morlock_village_mid_a" ],
    "method": "json",
    "weight": 1000,
    "object": {
      "fill_ter": "t_rock_floor",
      "rows": [
        "######  ################",
        "####       ##      #####",
        "##                   ###",
        "###                 ####",
        "####                ####",
        "##                    ##",
        "###                     ",
        "##                      ",
        "###                   ##",
        "####                ####",
        "###                   ##",
        "####                ####",
        "######            ######",
        "########        ########",
        "############# ##########",
        "########################",
        " #######################",
        " #######################",
        "########################",
        "########################",
        "########################",
        "########################",
        "########################",
        "###############  #######"
      ],
      "rotation": [ 0, 3 ],
      "palettes": [ "morlock_village" ],
      "place_nested": [
        { "chunks": [ "morlock_mid_a_ring" ], "x": 0, "y": 0 },
        { "chunks": [ [ "null", 20 ], [ "morlock_mid_core", 80 ] ], "x": 0, "y": 0 }
      ]
    }
  },
  {
    "type": "mapgen",
    "om_terrain": [ "morlock_village_mid_a" ],
    "method": "json",
    "weight": 1000,
    "object": {
      "fill_ter": "t_rock_floor",
      "rows": [
        "########################",
        "########################",
        "########################",
        "########################",
        "########################",
        "########################",
        "########        ########",
        "#######          #######",
        "######            ######",
        "######            ######",
        "######            ######",
        "######            ######",
        "######            ######",
        "######            ######",
        "######            ######",
        "######            ######",
        " ######          #######",
        " #######        ########",
        "########################",
        "########################",
        "########################",
        " ###################### ",
        " ###################### ",
        "   ############  ####   "
      ],
      "rotation": 0,
      "palettes": [ "morlock_village" ],
      "place_terrain": [
        { "ter": "t_rock", "repeat": [ 5, 20 ], "x": [ 4, 20 ], "y": [ 4, 20 ] },
        { "ter": "t_dirt", "repeat": [ 5, 20 ], "x": [ 4, 20 ], "y": [ 4, 20 ] },
        { "ter": "t_rock_floor", "repeat": [ 5, 20 ], "x": [ 4, 20 ], "y": [ 4, 20 ] }
      ],
      "place_nested": [
        { "chunks": [ "morlock_mid_a_ring" ], "x": 0, "y": 0 },
        { "chunks": [ [ "null", 20 ], [ "morlock_mid_core", 80 ] ], "x": 0, "y": 0 }
      ]
    }
  },
  {
    "type": "mapgen",
    "om_terrain": [ "morlock_village_mid_a" ],
    "method": "json",
    "weight": 1000,
    "object": {
      "fill_ter": "t_rock_floor",
      "rows": [
        "########################",
        "########################",
        "########################",
        "########################",
        "########################",
        "########################",
        "########################",
        "########################",
        "########################",
        "########################",
        "########################",
        "########################",
        "########################",
        "########################",
        "########################",
        "########################",
        "########################",
        "########################",
        "########################",
        "########################",
        "########################",
        "########################",
        "########################",
        "########################"
      ],
      "rotation": 0,
      "palettes": [ "morlock_village" ],
      "place_terrain": [ { "ter": "t_water_sh", "repeat": [ 20, 50 ], "x": [ 4, 20 ], "y": [ 4, 20 ] } ],
      "place_nested": [
        { "chunks": [ "morlock_mid_a_ring" ], "x": 0, "y": 0 },
        { "chunks": [ [ "null", 20 ], [ "morlock_mid_core", 80 ] ], "x": 0, "y": 0 }
      ]
    }
  },
  {
    "type": "mapgen",
    "om_terrain": [ "morlock_village_mid_a" ],
    "method": "json",
    "weight": 1000,
    "object": {
      "fill_ter": "t_rock_floor",
      "rows": [
        "########################",
        "######.....#############",
        "####..........##########",
        "###............#########",
        "###............#########",
        "##..............########",
        "##..............########",
        "##..............########",
        "###............#########",
        "####..........##########",
        "#####........###########",
        "#######....#############",
        "###########.##...#######",
        "###########........#####",
        "#########............###",
        "#########............###",
        "##########............##",
        "############.........###",
        "#############.......####",
        "##############....######",
        "########################",
        "########################",
        "########################",
        "########################"
      ],
      "rotation": [ 0, 3 ],
      "palettes": [ "morlock_village" ],
      "place_nested": [
        { "chunks": [ "morlock_mid_a_ring" ], "x": 0, "y": 0 },
        { "chunks": [ [ "null", 20 ], [ "morlock_mid_core", 80 ] ], "x": 0, "y": 0 }
      ]
    }
  },
  {
    "type": "mapgen",
    "om_terrain": [ "morlock_village_mid_a" ],
    "method": "json",
    "weight": 1000,
    "object": {
      "fill_ter": "t_rock_floor",
      "rows": [
        "########################",
        "########################",
        "##########,,,,,,,#######",
        "#######,,,,,,,,,,,,#####",
        "#####,,,,,,,,,,,,,,,####",
        "######,,,,,,,,,,,,,#####",
        "#####,,,,,,,,,,,,,,,,###",
        "####,,,,,,,,,,,,,,,,####",
        "#####,,,,,,,,,,,,,,#####",
        "####,,,,,,,,,,,,,,,,,###",
        "###,,,,,,,,,,,,,,,,,,,##",
        "###,,,,,,,,,,,,,,,,,,###",
        "####,,,,,,,,,,,,,,,#####",
        "######,,,,,,,,,,########",
        "#######,,,,,,,##########",
        "########################",
        "########################",
        "########################",
        "########################",
        "########################",
        "########################",
        "########################",
        "########################",
        "########################"
      ],
      "rotation": [ 0, 3 ],
      "palettes": [ "morlock_village" ],
      "terrain": { ",": "t_sand" },
      "place_nested": [
        { "chunks": [ "morlock_mid_a_ring" ], "x": 0, "y": 0 },
        { "chunks": [ [ "null", 20 ], [ "morlock_mid_core", 80 ] ], "x": 0, "y": 0 }
      ]
    }
  },
  {
    "type": "mapgen",
    "om_terrain": [ "morlock_village_mid_a" ],
    "method": "json",
    "weight": 1000,
    "object": {
      "fill_ter": "t_rock_floor",
      "rows": [
        "########################",
        "########,,,,,,##########",
        "######,,,,,,,,,#########",
        "####,,,,,,,,,,,,,,######",
        "###,,,,,,,,,,,,,,,,,####",
        "###,,,,,,,,,,,,,,,,#####",
        "###,,,,,,,,,,,,,,,,,####",
        "####,,,,,,,,??,,,,######",
        "######,,??,,??,,########",
        "#######,,??,?,##########",
        "#####????????????#######",
        "###?????????????????####",
        "####????????????????####",
        "#####??????????????#####",
        "###??????????????????###",
        "#####??????;???????#####",
        "#####??;;?????;;?#######",
        "######??;;;;;?##########",
        "####;;;;;;;;;;;;########",
        "#####;;;;;;;;;;;########",
        "######;;;;;;;;;;;;;#####",
        "########;;;;;;;;;#######",
        "##########;;;;;;########",
        "########################"
      ],
      "rotation": 0,
      "palettes": [ "morlock_village" ],
      "place_terrain": [ { "ter": "t_water_sh", "repeat": [ 10, 20 ], "x": [ 4, 20 ], "y": [ 4, 20 ] } ],
      "terrain": { ",": "t_dirt", ";": "t_sand", "?": [ "t_sand", "t_dirt" ] },
      "place_nested": [
        { "chunks": [ "morlock_mid_a_ring" ], "x": 0, "y": 0 },
        { "chunks": [ [ "null", 20 ], [ "morlock_mid_core", 80 ] ], "x": 0, "y": 0 }
      ]
    }
  }
]
