[
  {
    "type": "mapgen",
    "method": "json",
    "om_terrain": [
      [ "prison_1_gs_3", "prison_1_gs_2", "prison_1_gs_1" ],
      [ "prison_1_gs_6", "prison_1_gs_5", "prison_1_gs_4" ],
      [ "prison_1_gs_9", "prison_1_gs_8", "prison_1_gs_7" ],
      [ "prison_1_gs_b_3", "prison_1_gs_b_2", "prison_1_gs_b_1" ],
      [ "prison_1_gs_b_6", "prison_1_gs_b_5", "prison_1_gs_b_4" ],
      [ "prison_1_gs_b_9", "prison_1_gs_b_8", "prison_1_gs_b_7" ]
    ],
    "weight": 250,
    "object": {
      "faction_owner": [
        { "id": "grim_sisters", "x": [ 0, 23 ], "y": [ 0, 23 ] },
        { "id": "grim_sisters", "x": [ 24, 47 ], "y": [ 0, 23 ] },
        { "id": "grim_sisters", "x": [ 48, 71 ], "y": [ 0, 23 ] },
        { "id": "grim_sisters", "x": [ 0, 23 ], "y": [ 24, 47 ] },
        { "id": "grim_sisters", "x": [ 24, 47 ], "y": [ 24, 47 ] },
        { "id": "grim_sisters", "x": [ 48, 71 ], "y": [ 24, 47 ] },
        { "id": "grim_sisters", "x": [ 0, 23 ], "y": [ 48, 71 ] },
        { "id": "grim_sisters", "x": [ 24, 47 ], "y": [ 48, 71 ] },
        { "id": "grim_sisters", "x": [ 48, 71 ], "y": [ 48, 71 ] },
        { "id": "grim_sisters", "x": [ 30, 42 ], "y": [ 120, 126 ] }
      ],
      "fill_ter": "t_dirt",
      "rows": [
        "                         sss________________sss                         ",
        "                         sss________________sss                         ",
        "                        sss________________sss                          ",
        "                       sss________________sss                           ",
        "                      sss________________sss                            ",
        " sssssssssssssssssssssss________________sss                             ",
        " s_____________________________________Q|-wwww----------------ww--ww--| ",
        " s_____________________________________s|hhh,,,=,,,,,,,,,,,,=,,,,,,,,,| ",
        " s_____________________________________s+,,,,d,|--------=---|G|h|h|h|h| ",
        " s_____________________________________s+,,,,dh|S,T|l,,,,,+~|,|g|g|g|g| ",
        " s_____________________________________s|hhh,,,+,,,|l,,,,,--|,|h|h|h|h| ",
        " s____Y____Y____Y____Y____Y____Y_______s|------|---|l,5555,l|,|,,,,,,,| ",
        " s____Y____Y____Y____Y____Y____Y_______s|,,,,,,,,,,|l,9,,,9l|G|------G| ",
        " s____Y____Y____Y____Y____Y____Y_______s@,,,,,,,,d,|l,5555,l|,,,,,,,|,| ",
        " s____Y____Y____Y____Y____Y____Y_______s@,,,,,,,,dh|l,,,,9,l|hth,hth|,| ",
        " s____Y____Y____Y____Y____Y____Y_______s|,,,,,,,,d,|l,5555,l|hth,hth|,| ",
        " sssssssssssssssssssssssssssssssssssssss|555559,,9,|l,,,,,,l|,,,,,,,|,| ",
        " |---------------------------------------------}}-------@-----R-G-R--G| ",
        " |                                           f ss f     s       s8   s| ",
        " |          sssssssssssssssssssssssssssssssssHssssHsssssssssssssssssss| ",
        " |          sffffffffffffffffffffffffffffffffffHHff     s             | ",
        " |          sf      3333                     f ss f     s             | ",
        " |    |---| sf                  X  X  X  X   f ss f     s    |---|    | ",
        " |    |>^^| sf                               f ss f     s    |^^>|    | ",
        " |    |^^^}ssf3                              f ss f     sssss}^^^|    | ",
        " |    |lll| sf3                              f ss f     s    |lll|    | ",
        " |    |---| sf3                              f ss f     s    |---|    | ",
        " |          sf3                 3333         f ss f     s             | ",
        " |      sssssffffffffffHHffffffffffffffffffffffHHff     ssssssss      | ",
        " |      s            f sssHssssssssssssssssssHssssf           8s      | ",
        " |    |-@------------|8ss |--RRR--------RRR--| ss8|------------@-|    | ",
        " |    |,,,,,,,,,,,lll| ss |,,,,,,,,,,,,,,,,,,| ss |lll,,,,,,,,,,,|    | ",
        " |    |,,,,,htth,,,,l| ss |,,htth,,,,,,htth,,| ss |l,,,,htth,,,,,|    | ",
        " |    |,,,,,htth,,,,l| ss R,,htth,,,,,,htth,,R ss |l,,,,htth,,,,,|    | ",
        " |    |,,,,,htth,,,,l| ss R,,htth,,,,,,htth,,R ss |l,,,,htth,,,,,|    | ",
        " |    |,,,,,,,,,,,lll| ss R,,htth,,,,,,htth,,R ss |lll,,,,,,,,,,,|    | ",
        " |    |-Z-ggggggg----| ss |,,,,,,,,,,,,,,,,,,| ss |---ggggggg--Z-|    | ",
        " |    |,,,,,,,,,,,,,,| ss |,,htth,,,,,,htth,9| ss |,,,,,,,,,,,9,,|    | ",
        " |    R>,,,,,,,,,,,,,=ssss=,,htth,,,,,,htth,,=ssss=,,,,,,,,,,,,,>R    | ",
        " |    R>,,,,,,,,,,,,,=ssss=,,htth,,,,,,htth,,=ssss=,,,,,,,,,,,,,>R    | ",
        " |    |,,,,9,,,,9,,,,| ss |,,htth,,,,,,htth,,| ss |,,,,,,,,,,,,,,|    | ",
        " |    |----|BGGB|----|fHHf|,,,,,,,,,,,,,,,,,,|fHHf|----|BGGB|----|    | ",
        " |    |T,,,B,,,,B,,bb| ss |--ccccc--|--------| ss |T,,,B,,,,B,,bb|    | ",
        " |    R,7,,Z,,,,Z,7,,R ss R,,,,,,,,,|zzzzzzzz| ss R,7,,Z,,,,Z,,,,R    | ",
        " |    |bb,,B,,,,B,,,T| ss |,,ttttt,,|,,,,,,,,| ss |bb,,B,,,,B,,,T|    | ",
        " |    |----|,,,,|----| sss=,,ttttt,,+,,,,,,,,| ss |----|,,,,|----|    | ",
        " |    |T,,,B,,,,B,,bb| ss |,,,,,,,,9|,,,,,,,<| ss |T,,,B,,,,B,,bb|    | ",
        " |    R,7,,Z,,,,Z,7,,R ss RSnnSceeee|zzzzzzzz| ss R,,7,Z,,,,Z,,,,R    | ",
        " |    |bb,,B,,,,B,,,T| ss |---------|--------| ss |bb,,B,,,,B,,,T|    | ",
        " |    |----|,,,,|----| ss R,b,b,b,+<|W,W,W,W,R ss |----|,,,,|----|    | ",
        " |    |T,,,B,,,,B,,bb| ss |,b,b,b,|-|,,,,,,,,| ss |T,,,B,,,,B,,bb|    | ",
        " |    R,7,,Z,,,,Z,7,,R sss=,,,,,,,,m|,tttttt,=sss R,7,,Z,,,,Z,,7,R    | ",
        " |    |bb,,B,,,,B,,,T| ss8|,b,b,b,,m|,,,,,,,,|8ss |bb,,B,,,,B,,,T|    | ",
        " |    |----|,,,,|----| ss R,b,b,b,,m|D,D,D,D,R ss |----|,,,,|----|    | ",
        " |    |T,,,B,,,,B,,bb| ss |---------|--------| ss |T,,,B,,,,B,,bb|    | ",
        " |    R,7,,Z,,,,Z,7,,R ss |,LLLLLL,C|o,,ooo,,| ss R,,7,Z,,,,Z,7,,R    | ",
        " |    |bb,,B,,,,B,,,T| sss+,,,,,,,,C|o,,,,,,,=sss |bb,,B,,,,B,,,T|    | ",
        " |    |----|,,,,|----|ffff|,,,CC,,hC|,,,,,,,,|ffff|----|,,,,|----|    | ",
        " |    |T,,,B,,,,B,,bb|    R,,,CC,,,C|th,,,,htR    |T,,,B,,,,B,,bb|    | ",
        " |    R,7,,Z,,,,Z,7,,R    R,,,CC,,,C|th,,,,htR    R,,7,Z,,,,Z,7,,R    | ",
        " |    |bb,,B,,,,B,,,T|    |,,,CC,,,C|,,,,,,,,|    |bb,,B,,,,B,,,T|    | ",
        " |    |----|,,,,|----|    |,,,CC,,hC|th,,,,,,|    |----|,,,,|----|    | ",
        " |    |T,,,B,,,,B,,bb|    R,,,,,,,,C|th,,,,htR    |T,,,B,,,,B,,bb|    | ",
        " |    R,,7,Z,,,,Z,7,,R    R,h,,,h,,C|,,,hh,htR    R,,7,Z,,,,Z,,7,R    | ",
        " |    |bb,,B,,,,B,,,T|    |CCCCCCCCC|ooottooo|    |bb,,B,,,,B,,,T|    | ",
        " |    |----|----|----|    |--RR-RR------RR---|    |----|----|----|    | ",
        " |                                                                    | ",
        " |                                                                    | ",
        " |                                                                    | ",
        " |                                                                    | ",
        " |--------------------------------------------------------------------| ",
        "                                                                        ",
        "########################################################################",
        "########################################################################",
        "########################################################################",
        "########################################################################",
        "#########################################################|--|###########",
        "#########################################################|^^|###########",
        "#########################################################|^^|###########",
        "#########################################################|^^|###########",
        "#########################################################|^^|###########",
        "#########################################################|^^|###########",
        "#########################################################|^^|###########",
        "#########################################################|^^|###########",
        "#########################################################|^^|###########",
        "#########################################################|^^|###########",
        "#########################################################|^^|###########",
        "#########################################################|^^|###########",
        "#########################################################|^^|###########",
        "#########################################################|^^|###########",
        "#########################################################|^^|###########",
        "#########################################################|^^|###########",
        "#########################################################|^^|###########",
        "#########################################################|^^|###########",
        "########|-------------------------------------------------^^---|########",
        "########|^^^^^^^^^^^^^^^^^^^^^^^^^^^^^^^^^^^^^^^^^^^^^^^^^^^^^^|########",
        "########|^^^^^^^^^^^^^^^^^^^^^^^^^^^^^^^^^^^^^^^^^^^^^^^^^^^^^^|########",
        "########|^^|-----------------------|^^|---------------------|^^|########",
        "########|^^|#######################|^^|#####################|^^|########",
        "########|^^|#######################|^^|#####################|^^|########",
        "########|^^|#######################|^^|#####################|^^|########",
        "########|^^|#######################|^^|#####################|^^|########",
        "########|^^|#######################|^^|#####################|^^|########",
        "########|^^|#######################|^^|#####################|^^|########",
        "########|^^|#######################|^^|#####################|^^|########",
        "########|^^|#######################|^^|#####################|^^|########",
        "########|^^|#######################|^^|#####################|^^|########",
        "########|^^|#######################|^^|#####################|^^|########",
        "########|^^|#######################|^^|#####################|^^|########",
        "########|^^|#######################|^^|#####################|^^|########",
        "########|^^|#######################|^^|#####################|^^|########",
        "########|^^|#######################|^^|#####################|^^|########",
        "########|^^|#######################|^^|#####################|^^|########",
        "########|^^|#######################|^^|#####################|^^|########",
        "########|^^|#######################|^^|#####################|^^|########",
        "#######||^^|######################||^^|#####################|^^||#######",
        "#######|P^^|######################|P^^|#####################|^^P|#######",
        "#######|^^^|######################|^^^|#####################|^^^|#######",
        "#######|424|######################|424|#####***********#####|424|#######",
        "#######|---|######################|---|#####*>///////$*#####|---|#######",
        "############################################*&/&&&&&&&*#################",
        "##############################|-----------|#*/////////*#################",
        "##############################|m,,,,>,,,,m|#*&/&&&&&&&*#################",
        "##############################|m,,,,,,,,,m|#*/////////*#################",
        "##############################|m,,,,,,,,,m|#*&/&&&&&&&*#################",
        "##############################|m,,,,,,,,,m|#*$////////*#################",
        "##############################|m,,,,,,,,,m|#*&&&&&&&&&*#################",
        "##############################|-----------|#***********#################",
        "########################################################################",
        "########################################################################",
        "########################################################################",
        "########################################################################",
        "########################################################################",
        "########################################################################",
        "########################################################################",
        "########################################################################",
        "########################################################################",
        "########################################################################",
        "########################################################################",
        "########################################################################",
        "########################################################################",
        "########################################################################",
        "########################################################################",
        "########################################################################"
      ],
      "palettes": [ "prison_palette" ],
      "place_zones": [
        { "type": "NPC_INVESTIGATE_ONLY", "faction": "grim_sisters", "x": [ 0, 23 ], "y": [ 0, 23 ] },
        { "type": "NPC_INVESTIGATE_ONLY", "faction": "grim_sisters", "x": [ 24, 47 ], "y": [ 0, 23 ] },
        { "type": "NPC_INVESTIGATE_ONLY", "faction": "grim_sisters", "x": [ 48, 71 ], "y": [ 0, 23 ] },
        { "type": "NPC_INVESTIGATE_ONLY", "faction": "grim_sisters", "x": [ 0, 23 ], "y": [ 24, 47 ] },
        { "type": "NPC_INVESTIGATE_ONLY", "faction": "grim_sisters", "x": [ 24, 47 ], "y": [ 24, 47 ] },
        { "type": "NPC_INVESTIGATE_ONLY", "faction": "grim_sisters", "x": [ 48, 71 ], "y": [ 24, 47 ] },
        { "type": "NPC_INVESTIGATE_ONLY", "faction": "grim_sisters", "x": [ 0, 23 ], "y": [ 48, 71 ] },
        { "type": "NPC_INVESTIGATE_ONLY", "faction": "grim_sisters", "x": [ 24, 47 ], "y": [ 48, 71 ] },
        { "type": "NPC_INVESTIGATE_ONLY", "faction": "grim_sisters", "x": [ 48, 71 ], "y": [ 48, 71 ] },
        { "type": "NPC_INVESTIGATE_ONLY", "faction": "grim_sisters", "x": [ 30, 42 ], "y": [ 121, 127 ] }
      ],
      "terrain": {
        "2": "t_concrete",
        "4": "t_concrete",
        "@": "t_door_metal_pickable",
        "}": "t_door_metal_locked",
        "R": "t_window_bars",
        "^": "t_concrete",
        "P": "t_concrete",
        "Y": "t_pavement_y",
        "Z": "t_door_bar_c",
        "9": "t_floor",
        "7": "t_floor",
        "/": "t_thconc_floor",
        "&": "t_thconc_floor",
        "$": "t_thconc_floor",
        "*": "t_wall_metal",
        "Q": "t_sidewalk",
        "~": "t_hole"
      },
      "furniture": {
        "X": "f_exercise",
        "C": "f_counter",
        "P": "f_rack",
        "2": "f_home_furnace",
        "4": "f_water_heater",
        "L": "f_locker",
        "$": "f_air_conditioner",
        "&": "f_hanging_meathook"
      },
      "items": {
        "l": [
          { "item": "prison_weapons", "chance": 30 },
          { "item": "prison_armor", "chance": 30 },
          { "item": "cop_torso", "chance": 20 },
          { "item": "cop_pants", "chance": 20 },
          { "item": "cop_shoes", "chance": 20 }
        ],
        "C": [ { "item": "hand_tools", "chance": 40 } ],
        "L": [ { "item": "hand_tools", "chance": 40 } ],
        "P": [ { "item": "tools_plumbing", "chance": 100, "repeat": [ 1, 3 ] } ],
        "&": [ { "item": "corpse_male", "chance": 45 } ]
      },
      "liquids": { "4": { "liquid": "water_clean", "amount": [ 0, 100 ] } },
      "place_monsters": [
        { "monster": "GROUP_ZOMBIE_PRISON", "x": [ 0, 23 ], "y": [ 72, 95 ], "density": 0.3 },
        { "monster": "GROUP_ZOMBIE_PRISON", "x": [ 24, 47 ], "y": [ 72, 95 ], "density": 0.3 },
        { "monster": "GROUP_ZOMBIE_PRISON", "x": [ 48, 71 ], "y": [ 72, 95 ], "density": 0.3 },
        { "monster": "GROUP_ZOMBIE_PRISON", "x": [ 0, 23 ], "y": [ 96, 117 ], "density": 0.3 },
        { "monster": "GROUP_ZOMBIE_PRISON", "x": [ 24, 47 ], "y": [ 96, 117 ], "density": 0.3 },
        { "monster": "GROUP_ZOMBIE_PRISON", "x": [ 48, 71 ], "y": [ 96, 117 ], "density": 0.3 },
        { "monster": "GROUP_ZOMBIE_COP", "x": [ 0, 23 ], "y": [ 72, 95 ], "density": 0.2 },
        { "monster": "GROUP_ZOMBIE_COP", "x": [ 24, 47 ], "y": [ 72, 95 ], "density": 0.2 },
        { "monster": "GROUP_ZOMBIE_COP", "x": [ 48, 71 ], "y": [ 72, 95 ], "density": 0.2 },
        { "monster": "GROUP_ZOMBIE_COP", "x": [ 0, 23 ], "y": [ 96, 117 ], "density": 0.2 },
        { "monster": "GROUP_ZOMBIE_COP", "x": [ 24, 47 ], "y": [ 96, 117 ], "density": 0.2 },
        { "monster": "GROUP_ZOMBIE_COP", "x": [ 48, 71 ], "y": [ 96, 117 ], "density": 0.2 }
      ],
      "place_monster": [
        { "monster": "mon_zombie_technician", "x": [ 8, 10 ], "y": [ 110, 115 ], "chance": 100 },
        { "monster": "mon_zombie_technician", "x": [ 33, 35 ], "y": [ 110, 115 ], "chance": 100 },
        { "monster": "mon_zombie_technician", "x": [ 57, 59 ], "y": [ 110, 115 ], "chance": 100 }
      ],
      "place_vehicles": [ { "vehicle": "bus_prison", "x": 8, "y": 12, "chance": 25, "rotation": 180 } ],
      "npcs": { "8": { "class": "bandit_gs" }, "9": { "class": "bandit_gs" } },
      "place_npcs": [
        { "class": "NPC_bandit_gs_cook", "x": 28, "y": 46 },
        { "class": "NPC_bandit_gs_prisoner1", "x": 61, "y": 42 },
        { "class": "bandit_gs_g", "x": 55, "y": 40 },
        { "class": "bandit_gs_g", "x": 60, "y": 40 },
        { "class": "bandit_gs", "x": 56, "y": 34 },
        { "class": "NPC_bandit_gs_e", "x": 50, "y": 14 }
      ],
      "nested": { "7": { "chunks": [ [ "null", 65 ], [ "NPC_bandit_gs_slave_spawn", 35 ] ] } },
      "signs": { "Q": { "signage": "Trespassers will be shot. Survivors will be enslaved." } }
    }
  },
  {
    "type": "mapgen",
    "method": "json",
    "om_terrain": [
      [ "prison_1_gs_2f_3", "prison_1_gs_2f_2", "prison_1_gs_2f_1" ],
      [ "prison_1_gs_2f_6", "prison_1_gs_2f_5", "prison_1_gs_2f_4" ],
      [ "prison_1_gs_2f_9", "prison_1_gs_2f_8", "prison_1_gs_2f_7" ]
    ],
    "weight": 250,
    "object": {
      "faction_owner": [
        { "id": "grim_sisters", "x": [ 0, 23 ], "y": [ 0, 23 ] },
        { "id": "grim_sisters", "x": [ 24, 47 ], "y": [ 0, 23 ] },
        { "id": "grim_sisters", "x": [ 48, 71 ], "y": [ 0, 23 ] },
        { "id": "grim_sisters", "x": [ 0, 23 ], "y": [ 24, 47 ] },
        { "id": "grim_sisters", "x": [ 24, 47 ], "y": [ 24, 47 ] },
        { "id": "grim_sisters", "x": [ 48, 71 ], "y": [ 24, 47 ] },
        { "id": "grim_sisters", "x": [ 0, 23 ], "y": [ 48, 71 ] },
        { "id": "grim_sisters", "x": [ 24, 47 ], "y": [ 48, 71 ] },
        { "id": "grim_sisters", "x": [ 48, 71 ], "y": [ 48, 71 ] }
      ],
      "rows": [
        "AAAAAAAAAAAAAAAAAAAAAAAAAAAAAAAAAAAAAAAAAAAAAAAAAAAAAAAAAAAAAAAAAAAAAAAA",
        "AAAAAAAAAAAAAAAAAAAAAAAAAAAAAAAAAAAAAAAAAAAAAAAAAAAAAAAAAAAAAAAAAAAAAAAA",
        "AAAAAAAAAAAAAAAAAAAAAAAAAAAAAAAAAAAAAAAAAAAAAAAAAAAAAAAAAAAAAAAAAAAAAAAA",
        "AAAAAAAAAAAAAAAAAAAAAAAAAAAAAAAAAAAAAAAAAAAAAAAAAAAAAAAAAAAAAAAAAAAAAAAA",
        "AAAAAAAAAAAAAAAAAAAAAAAAAAAAAAAAAAAAAAAAAAAAAAAAAAAAAAAAAAAAAAAAAAAAAAAA",
        "AAAAAAAAAAAAAAAAAAAAAAAAAAAAAAAAAAAAAAAAAAAAAAAAAAAAAAAAAAAAAAAAAAAAAAAA",
        "AAAAAAAAAAAAAAAAAAAAAAAAAAAAAAAAAAAAAAAA5444444444444444444444444444445A",
        "AAAAAAAAAAAAAAAAAAAAAAAAAAAAAAAAAAAAAAAA1.............................1A",
        "AAAAAAAAAAAAAAAAAAAAAAAAAAAAAAAAAAAAAAAA1.............................1A",
        "AAAAAAAAAAAAAAAAAAAAAAAAAAAAAAAAAAAAAAAA1.............................1A",
        "AAAAAAAAAAAAAAAAAAAAAAAAAAAAAAAAAAAAAAAA1.............................1A",
        "AAAAAAAAAAAAAAAAAAAAAAAAAAAAAAAAAAAAAAAA1.............................1A",
        "AAAAAAAAAAAAAAAAAAAAAAAAAAAAAAAAAAAAAAAA1.............................1A",
        "AAAAAAAAAAAAAAAAAAAAAAAAAAAAAAAAAAAAAAAA1.............................1A",
        "AAAAAAAAAAAAAAAAAAAAAAAAAAAAAAAAAAAAAAAA1.............................1A",
        "AAAAAAAAAAAAAAAAAAAAAAAAAAAAAAAAAAAAAAAA1.............................1A",
        "AAAAAAAAAAAAAAAAAAAAAAAAAAAAAAAAAAAAAAAA1.............................1A",
        "A|--------------------------------------------------------------------|A",
        "A|AAAAAAAAAAAAAAAAAAAAAAAAAAAAAAAAAAAAAAAAAAAAAAAAAAAAAAAAAAAAAAAAAAAA|A",
        "A|AAAAAAAAAAAAAAAAAAAAAAAAAAAAAAAAAAAAAAAAAAAAAAAAAAAAAAAAAAAAAAAAAAAA|A",
        "A|AAAAAAAAAAAAAAAAAAAAAAAAAAAAAAAAAAAAAAAAAAAAAAAAAAAAAAAAAAAAAAAAAAAA|A",
        "A|AAAAAAAAAAAAAAAAAAAAAAAAAAAAAAAAAAAAAAAAAAAAAAAAAAAAAAAAAAAAAAAAAAAA|A",
        "A|AAAA|^^^|AAAAAAAAAAAAAAAAAAAAAAAAAAAAAAAAAAAAAAAAAAAAAAAAAA|^^^|AAAA|A",
        "A|AAAA^<^^^AAAAAAAAAAAAAAAAAAAAAAAAAAAAAAAAAAAAAAAAAAAAAAAAAA^^^<^AAAA|A",
        "A|AAAA^^^^8AAAAAAAAAAAAAAAAAAAAAAAAAAAAAAAAAAAAAAAAAAAAAAAAAA8^^^^AAAA|A",
        "A|AAAA^^^^^AAAAAAAAAAAAAAAAAAAAAAAAAAAAAAAAAAAAAAAAAAAAAAAAAA^^^^^AAAA|A",
        "A|AAAA|^^^|AAAAAAAAAAAAAAAAAAAAAAAAAAAAAAAAAAAAAAAAAAAAAAAAAA|^^^|AAAA|A",
        "A|AAAAAAAAAAAAAAAAAAAAAAAAAAAAAAAAAAAAAAAAAAAAAAAAAAAAAAAAAAAAAAAAAAAA|A",
        "A|AAAAAAAAAAAAAAAAAAAAAAAAAAAAAAAAAAAAAAAAAAAAAAAAAAAAAAAAAAAAAAAAAAAA|A",
        "A|AAAAAAAAAAAAAAAAAAAAAAAAAAAAAAAAAAAAAAAAAAAAAAAAAAAAAAAAAAAAAAAAAAAA|A",
        "A|AAAA|--------------|AAAA54444444444444444445AAAA|--------------|AAAA|A",
        "A|AAAA|^6^6^6^^6^6^6^|AAAA1..................1AAAA|^6^6^6^^6^6^6^|AAAA|A",
        "A|AAAA|^^^^^^^^^^^^^^|AAAA1..................1AAAA|^^^^^^^^^^^^^^|AAAA|A",
        "A|AAAA|^^^^^^^^^^^^^^|AAAA1..................1AAAA|^^^^^^^^^^^^^^|AAAA|A",
        "A|AAAA|^^^^^^^^^^^^^^|AAAA1..................1AAAA|^^^^^^^^^^^^^^|AAAA|A",
        "A|AAAA|^S^S^^^^^^S^S^|AAAA1..................1AAAA|^S^S^^^^^^S^S^|AAAA|A",
        "A|AAAA|------^^------|AAAA1..................1AAAA|------^^------|AAAA|A",
        "A|AAAA|,,,,,,,,,,,,,,|AAAA1..................1AAAA|,,,,,,,,,,,,,,|AAAA|A",
        "A|AAAAR<,,,,,,,,,,,,,RAAAA1..................1AAAAR,,,,,,,,,,,,,<RAAAA|A",
        "A|AAAAR<,,,,,,,,,,,,,RAAAA1..................1AAAAR,,,,,,,,,,,,,<RAAAA|A",
        "A|AAAA|,,,,9,,,,9,,,,|AAAA1..................1AAAA|,,,,9,,,,9,,,,|AAAA|A",
        "A|AAAA|----|BGGB|----|AAAA1..................1AAAA|----|BGGB|----|AAAA|A",
        "A|AAAA|T,,,B,,,,B,,bb|AAAA1..................1AAAA|T,,,B,,,,B,,bb|AAAA|A",
        "A|AAAAR,,,,Z,,,,Z,,,,RAAAA1..................1AAAAR,,,,Z,,,,G,,,,RAAAA|A",
        "A|AAAA|bb,,B,,,,B,,,T|AAAA1..................1AAAA|bb,,B,,,,B,,,T|AAAA|A",
        "A|AAAA|----|,,,,|----|AAAA1..................1AAAA|----|,,,,|----|AAAA|A",
        "A|AAAA|T,,,B,,,,B,,bb|AAAA1..................1AAAA|T,,,B,,,,B,,bb|AAAA|A",
        "A|AAAAR,,,,Z,,,,Z,,,,RAAAA1..................1AAAAR,,,,Z,,,,Z,,,,RAAAA|A",
        "A|AAAA|bb,,B,,,,B,,,T|AAAA1..................1AAAA|bb,,B,,,,B,,,T|AAAA|A",
        "A|AAAA|----|,,,,|----|AAAA1..................1AAAA|----|,,,,|----|AAAA|A",
        "A|AAAA|T,,,B,,,,B,,bb|AAAA1..................1AAAA|T,,,B,,,,B,,bb|AAAA|A",
        "A|AAAAR,,,,Z,,,,Z,,,,RAAAA1..................1AAAAR,,,,Z,,,,Z,,,,RAAAA|A",
        "A|AAAA|bb,,B,,,,B,,,T|AAAA1..................1AAAA|bb,,B,,,,B,,,T|AAAA|A",
        "A|AAAA|----|,,,,|----|AAAA1..................1AAAA|----|,,,,|----|AAAA|A",
        "A|AAAA|T,,,B,,,,B,,bb|AAAA1..................1AAAA|T,,,B,,,,B,,bb|AAAA|A",
        "A|AAAAR,,,,G,,,,G,,,,RAAAA1..................1AAAAR,,,,G,,,,Z,,,,RAAAA|A",
        "A|AAAA|bb,,B,,,,B,,,T|AAAA1..................1AAAA|bb,,B,,,,B,,,T|AAAA|A",
        "A|AAAA|----|,,,,|----|AAAA1..................1AAAA|----|,,,,|----|AAAA|A",
        "A|AAAA|T,,,B,,,,B,,bb|AAAA1..................1AAAA|T,,,B,,,,B,,bb|AAAA|A",
        "A|AAAAR,,,,Z,,,,Z,,,,RAAAA1..................1AAAAR,,,,Z,,,,Z,,,,RAAAA|A",
        "A|AAAA|bb,,B,,,,B,,,T|AAAA1..................1AAAA|bb,,B,,,,B,,,T|AAAA|A",
        "A|AAAA|----|,,,,|----|AAAA1..................1AAAA|----|,,,,|----|AAAA|A",
        "A|AAAA|T,,,B,,,,B,,bb|AAAA1..................1AAAA|T,,,B,,,,B,,bb|AAAA|A",
        "A|AAAAR,,,,Z,,,,Z,,,,RAAAA1..................1AAAAR,,,,Z,,,,Z,,,,RAAAA|A",
        "A|AAAA|bb,,B,,,,B,,,T|AAAA1..................1AAAA|bb,,B,,,,B,,,T|AAAA|A",
        "A|AAAA|----|----|----|AAAA54444444444444444445AAAA|----|----|----|AAAA|A",
        "A|AAAAAAAAAAAAAAAAAAAAAAAAAAAAAAAAAAAAAAAAAAAAAAAAAAAAAAAAAAAAAAAAAAAA|A",
        "A|AAAAAAAAAAAAAAAAAAAAAAAAAAAAAAAAAAAAAAAAAAAAAAAAAAAAAAAAAAAAAAAAAAAA|A",
        "A|AAAAAAAAAAAAAAAAAAAAAAAAAAAAAAAAAAAAAAAAAAAAAAAAAAAAAAAAAAAAAAAAAAAA|A",
        "A|AAAAAAAAAAAAAAAAAAAAAAAAAAAAAAAAAAAAAAAAAAAAAAAAAAAAAAAAAAAAAAAAAAAA|A",
        "A|--------------------------------------------------------------------|A",
        "AAAAAAAAAAAAAAAAAAAAAAAAAAAAAAAAAAAAAAAAAAAAAAAAAAAAAAAAAAAAAAAAAAAAAAAA"
      ],
      "palettes": [ "prison_palette" ],
      "place_zones": [
        { "type": "NPC_INVESTIGATE_ONLY", "faction": "grim_sisters", "x": [ 0, 23 ], "y": [ 0, 23 ] },
        { "type": "NPC_INVESTIGATE_ONLY", "faction": "grim_sisters", "x": [ 24, 47 ], "y": [ 0, 23 ] },
        { "type": "NPC_INVESTIGATE_ONLY", "faction": "grim_sisters", "x": [ 48, 71 ], "y": [ 0, 23 ] },
        { "type": "NPC_INVESTIGATE_ONLY", "faction": "grim_sisters", "x": [ 0, 23 ], "y": [ 24, 47 ] },
        { "type": "NPC_INVESTIGATE_ONLY", "faction": "grim_sisters", "x": [ 24, 47 ], "y": [ 24, 47 ] },
        { "type": "NPC_INVESTIGATE_ONLY", "faction": "grim_sisters", "x": [ 48, 71 ], "y": [ 24, 47 ] },
        { "type": "NPC_INVESTIGATE_ONLY", "faction": "grim_sisters", "x": [ 0, 23 ], "y": [ 48, 71 ] },
        { "type": "NPC_INVESTIGATE_ONLY", "faction": "grim_sisters", "x": [ 24, 47 ], "y": [ 48, 71 ] },
        { "type": "NPC_INVESTIGATE_ONLY", "faction": "grim_sisters", "x": [ 48, 71 ], "y": [ 48, 71 ] }
      ],
      "terrain": {
        "A": "t_open_air",
        ".": "t_flat_roof",
        "1": "t_gutter_north",
        "4": "t_gutter_west",
        "5": "t_gutter_drop",
        "^": "t_concrete",
        "8": "t_concrete",
        "9": "t_floor",
        "6": "t_concrete",
        "2": "t_gates_control_metal",
        "@": "t_door_metal_pickable",
        "R": "t_window_bars",
        "Z": "t_door_bar_o"
      },
      "furniture": { "6": "f_shower" },
      "npcs": { "8": { "class": "bandit_gs" }, "9": { "class": "bandit_gs" } }
    }
  }
]
