[
  {
    "type": "mapgen",
    "method": "json",
    "om_terrain": [ "curious_structure_roof" ],
    "weight": 300,
    "object": {
      "fill_ter": "t_open_air",
      "rows": [
        "                        ",
        "       ==========       ",
        "       =________=       ",
        "       =________=       ",
        " =======________======= ",
        "==____________________==",
        "=______________________=",
        "=______________________=",
        "=______________________=",
        "=______________________=",
        "=______________________=",
        "=______________________=",
        "==____________________==",
        " =____________________= ",
        " =____________________= ",
        " =____________________= ",
        " =____________________= ",
        " =____________________= ",
        " =____________________= ",
        " =____________________= ",
        " ==__________________== ",
        "  =__________________=  ",
        "  =__________________=  ",
        "  =__________________=  "
      ],
      "terrain": { "=": "t_rock_wall_half", "_": "t_rock_floor_no_roof" }
    }
  },
  {
    "type": "mapgen",
    "method": "json",
    "om_terrain": [ "curious_structure_roof_2" ],
    "weight": 300,
    "object": {
      "fill_ter": "t_open_air",
      "rows": [
        "  =__________________=  ",
        "  =__________________=  ",
        "  =__________________=  ",
        "  =__________________=  ",
        "===__________________===",
        "=______________________=",
        "=______________________=",
        "=______________________=",
        "=______________________=",
        "=______________________=",
        "=______________________=",
        "=______________________=",
        "=______________________=",
        "==____________________==",
        " =____________________= ",
        " =____________________= ",
        " =____________________= ",
        " =____________________= ",
        " =____________________= ",
        " ========______======== ",
        "        =______=        ",
        "        =______=        ",
        "        =______=        ",
        "        ========        "
      ],
      "terrain": { "=": "t_rock_wall_half", "_": "t_rock_floor_no_roof" }
    }
  },
  {
    "type": "mapgen",
    "method": "json",
    "om_terrain": [ "curious_structure" ],
    "weight": 300,
    "object": {
      "rows": [
        ",,,,,,,##########,,,,,,,",
        ",,,,,,,#l......l#,,,,,,,",
        ",,,,,,,#n..=>..n#,,,,,,,",
        ",,,,,,,#n......n#,,,,,,,",
        ",##11###---XX---###11##,",
        "##_____.........._____##",
        "3____I_.b..CC..b._I____2",
        "3______..........______2",
        "#_pppppppprrrrpppppppp_#",
        "#_________rrrr_________#",
        "2_pppppppprrrrpppppppp_3",
        "2_________rrrr_________3",
        "##________rrrr________##",
        ",#------|_rrrr_|------#,",
        ",#BD_BDD|-|++|-|DDB_DB#,",
        ",#B__B__BB|__|BB__B__B#,",
        ",#{_______|__|_______{#,",
        ",#{_______+__+_______{#,",
        ",#B__B__B_|__|_B__B__B#,",
        ",#BD_BD_BD|__|DB_DB_DB#,",
        ",##---|---|__|---|---##,",
        ",,#tt.|.sC|__|Cs.|..&#,,",
        ",,#...+...|__|...+...#,,",
        ",,#P..|...|__|...|..s#,,"
      ],
      "palettes": [ "arcana_palette" ],
      "terrain": {
        "#": "t_rock",
        "{": "t_floor",
        "B": "t_floor",
        "D": "t_floor",
        "P": "t_rock_floor",
        "l": "t_rock_floor",
        "p": "t_floor"
      },
      "furniture": { "P": "f_bench", "l": "f_locker" },
      "items": {
        "{": [ { "item": "gear_survival", "chance": 50, "repeat": 2 } ],
        "l": [ { "item": "cleaning", "chance": 50 } ],
        "n": [ { "item": "rural_church_medical_items", "chance": 25, "repeat": 2 } ]
      },
      "place_loot": [ { "item": "holy_symbol", "x": 11, "y": 6 }, { "item": "note_flame", "x": 12, "y": 6 } ],
      "place_monster": [ { "group": "GROUP_CHURCH_ZOMBIE", "x": [ 3, 20 ], "y": [ 5, 18 ], "repeat": [ 3, 6 ] } ]
    }
  },
  {
    "type": "mapgen",
    "method": "json",
    "om_terrain": [ "curious_structure_2" ],
    "weight": 300,
    "object": {
      "rows": [
        ",,#---|...+__+...|---#,,",
        ",,#p..|...|__|...|..s#,,",
        ",,#...+...|__|...+...#,,",
        ",,#tt.|.sC|__|Cs.|..&#,,",
        "###---|---|++|---|---###",
        "#______________________#",
        "3______________________2",
        "3..HHHHHHHH__HHHHHHHH..2",
        "#F.EEEEEEEE__EEEEEEEE.F#",
        "#F.EEEEEEEE__EEEEEEEE.F#",
        "2..HHHHHHHH__HHHHHHHH..3",
        "2______________________3",
        "#______________________#",
        "##--++--|______|--++--##",
        ",#C....v|++--++|......#,",
        ",#f.....|rrrrrr|].....#,",
        ",#s.hee.|rrrrrr|]..ddd#,",
        ",#o.hee.|P_rr_P|]...hd#,",
        ",#n..hh.|P_rr_P|].....#,",
        ",###11###P_rr_P###11###,",
        ",,,,,,,,#__rr__#,,,,,,,,",
        ",,,,,,,,#R_rr_R#,,,,,,,,",
        ",,,,,,,,###++###,,,,,,,,",
        ",,,,,,,,,,,,,,,,,,,,,,,,"
      ],
      "palettes": [ "arcana_palette" ],
      "terrain": { "#": "t_rock", "E": "t_floor", "H": "t_floor", "P": "t_floor", "R": "t_floor" },
      "furniture": { "E": "f_table", "F": "f_fireplace", "H": "f_chair", "P": "f_bench", "R": "f_rack_coat" },
      "items": {
        "]": [ { "item": "homebooks", "chance": 50, "repeat": 2 }, { "item": "cleansing_flame_books", "chance": 25 } ],
        "d": [ { "item": "office_mess", "chance": 50, "repeat": 2 } ]
      },
      "place_loot": [
        { "item": "CF_golden_scale", "x": 19, "y": 16, "chance": 50, "repeat": 3 },
        { "item": "note_flame_tenet", "x": [ 19, 20 ], "y": 16 },
        { "group": "produce", "x": 2, "y": 15, "chance": 80, "repeat": 4 },
        { "group": "oven", "x": 2, "y": 17, "chance": 40, "repeat": 2 },
        { "group": "cannedfood", "x": 2, "y": 18, "chance": 80, "repeat": 5 }
      ],
      "place_monster": [ { "group": "GROUP_CHURCH_ZOMBIE", "x": [ 3, 20 ], "y": [ 5, 18 ], "repeat": [ 3, 6 ] } ]
    }
  },
  {
    "type": "mapgen",
    "method": "json",
    "om_terrain": [ "curious_structure_b" ],
    "weight": 300,
    "object": {
      "rows": [
        "########################",
        "###########...##########",
        "##########..<..#########",
        "##########.....#########",
        "###########...##########",
        "############+###########",
        "#####]]]]]#...#..h..####",
        "####......#...#.ddd..###",
        "###.......+...+.......##",
        "###]..]]..#...#..eh..]##",
        "###]..]]..#...#..eh..]##",
        "###]..]]..##+##..eh..]##",
        "###]..]]..#...#..eh..]##",
        "###]..]]..#...#..eh..]##",
        "###.......#...#.......##",
        "####.....{#...#{.....###",
        "######++###...###++#####",
        "####{....{#...#{....{###",
        "####{....{#...#{....{###",
        "####{....{#...#{....{###",
        "####......#...#......###",
        "####{....{#...#{....{###",
        "####{....{#...#{....{###",
        "####{....{#...#{....{###"
      ],
      "palettes": [ "arcana_palette" ],
      "items": { "]": [ { "item": "cleansing_flame_books", "chance": 75, "repeat": 2 } ] },
      "place_loot": [
        { "item": "arcanemap", "x": [ 16, 18 ], "y": 7, "chance": 50 },
        { "item": "book_magicfordummies", "x": [ 16, 18 ], "y": 7, "chance": 90 },
        { "group": "cleansing_flame_spells", "x": 17, "y": [ 9, 13 ], "chance": 10, "repeat": 2 },
        { "group": "office_mess", "x": 9, "y": 15, "chance": 50, "repeat": 5 },
        { "group": "office_mess", "x": 15, "y": 15, "chance": 50, "repeat": 5 },
        { "group": "cleansing_flame_crafting", "x": 9, "y": [ 17, 19 ], "chance": 50, "repeat": 5 },
        { "item": "CF_golden_scale", "x": 9, "y": [ 17, 19 ], "chance": 30, "repeat": 3 },
        { "group": "cleansing_flame_crafting", "x": 15, "y": [ 17, 19 ], "chance": 50, "repeat": 5 },
        { "item": "CF_golden_scale", "x": 15, "y": [ 17, 19 ], "chance": 30, "repeat": 3 },
        { "group": "cleansing_flame_gear", "x": 9, "y": [ 21, 23 ], "chance": 25, "repeat": 3 },
        { "group": "cleansing_flame_gear", "x": 15, "y": [ 21, 23 ], "chance": 25, "repeat": 3 },
        { "group": "cleansing_flame_gear_consumables", "x": 4, "y": [ 17, 19 ], "chance": 40, "repeat": 3 },
        { "group": "cleansing_flame_gear_consumables", "x": 20, "y": [ 17, 19 ], "chance": 40, "repeat": 3 },
        { "group": "cleansing_flame_gear_magic", "x": 4, "y": [ 21, 23 ], "chance": 20, "repeat": 3 },
        { "group": "cleansing_flame_gear_magic", "x": 20, "y": [ 21, 23 ], "chance": 20, "repeat": 3 },
        { "group": "cleansing_flame_casualties", "x": [ 11, 13 ], "y": [ 6, 23 ], "repeat": 4 }
      ],
      "place_monster": [ { "group": "GROUP_CF_BASEMENT", "x": [ 5, 19 ], "y": [ 17, 23 ], "repeat": [ 2, 4 ] } ]
    }
  },
  {
    "type": "mapgen",
    "method": "json",
    "om_terrain": [ "curious_structure_b_2" ],
    "weight": 300,
    "object": {
      "rows": [
        "######++###...###++#####",
        "###.....###...###.....##",
        "##......###...###......#",
        "##...#######+#######...#",
        "##..##.............##..#",
        "##..#...............#..#",
        "##..#...=========...#..#",
        "##..#..==.AF.CK.==..#..#",
        "##++#..=.........=..#++#",
        "##.....=.........=.....#",
        "##.....=...~~~...=.....#",
        "###...==..I~S~I..==...##",
        "####.......~~~.......###",
        "#####...............####",
        "######.............#####",
        "#######...I...I...######",
        "###########...##########",
        "############X###########",
        "###########...##########",
        "##########.....#########",
        "##########..>..#########",
        "###########...##########",
        "########################",
        "########################"
      ],
      "palettes": [ "arcana_palette" ],
      "furniture": { ">": "f_blade_upright" },
      "set": [ { "point": "trap", "id": "tr_portal", "x": [ 8, 16 ], "y": [ 8, 9 ] } ],
      "place_loot": [
        { "group": "tools_blacksmith", "x": 13, "y": 7, "chance": 50, "repeat": 3 },
        { "item": "candle_warding_active", "x": 13, "y": 7, "chance": 50 },
        { "group": "cleansing_flame_casualties", "x": [ 8, 16 ], "y": [ 12, 14 ], "repeat": 4 }
      ],
      "place_monster": [ { "group": "GROUP_CF_BASEMENT", "x": [ 8, 16 ], "y": [ 8, 14 ], "repeat": [ 2, 4 ] } ]
    }
  },
  {
    "type": "mapgen",
    "method": "json",
    "om_terrain": [ "curious_structure_b2" ],
    "weight": 300,
    "object": {
      "rows": [
        "###===================##",
        "##==^..^^^^^^^^^^^..^==#",
        "#==^....^^=====^^....^==",
        "#=^^...^^=.....=^^...^^=",
        "#==^^.^^^=..a..=^^^.^^==",
        "#==^....^^=.=.=^^....^==",
        "#=^^......=...=......^^=",
        "#=^.........=.........^=",
        "#=.....................=",
        "#=......==.....==......=",
        "#==...................==",
        "##==.................==#",
        "#==......=.....=......==",
        "#=.........=.=.........=",
        "#=.....=...===...=.....=",
        "#=..........=..........=",
        "#=........=...=........=",
        "#=^.....====.====.....^=",
        "#=^^...==.......==...^^=",
        "#==^^..=..=====..=..^^==",
        "##======.==...==.======#",
        "###=====.........=====##",
        "###========...========##",
        "###=========.=========##"
      ],
      "palettes": [ "arcana_palette" ],
      "terrain": { "#": "t_rock", "=": [ "t_rock", [ "t_wall_resin", 2 ] ], ".": [ "t_rock_floor", [ "t_floor_resin", 2 ] ] },
      "place_loot": [
        { "group": "cleansing_flame_casualties_inferno", "x": [ 10, 14 ], "y": [ 8, 12 ], "chance": 75, "repeat": 3 },
        { "item": "hand_of_armok", "x": 12, "y": 4 }
      ],
      "place_monster": [
        { "group": "GROUP_NETHER_LAVA", "x": [ 2, 22 ], "y": [ 5, 17 ], "repeat": [ 5, 10 ] },
        { "monster": "mon_spirit_of_fire", "x": [ 10, 14 ], "y": 3 }
      ]
    }
  },
  {
    "type": "mapgen",
    "method": "json",
    "om_terrain": [ "curious_structure_b2_2" ],
    "weight": 300,
    "object": {
      "rows": [
        "####========_=========##",
        "####=___===____===___=##",
        "####=_=_==__==__==_=_=##",
        "####=_=_=__====__=_=_=##",
        "####=_=___======___=_=##",
        "####=_==============_=##",
        "####=__%===========__=##",
        "####==__===%====%%__==##",
        "#####==__%=r%==%___==###",
        "######=%___rr___%%==####",
        "########%#==_%=#########",
        "#########=%%_=%%%#######",
        "########%%=__r%aC#######",
        "########%__r__...#######",
        "########Ca.rr_.aC#######",
        "########...rrr...#######",
        "########Ca.rrr.aC#######",
        "############+###########",
        "###########...##########",
        "##########.....#########",
        "##########..<..#########",
        "###########...##########",
        "########################",
        "########################"
      ],
      "palettes": [ "arcana_palette" ],
      "terrain": {
        "#": "t_rock",
        "=": [ "t_rock", [ "t_wall_resin", 2 ] ],
        "_": [ "t_rock_floor", [ "t_floor_resin", 2 ] ],
        "%": [ "t_rock_floor", [ "t_floor_resin", 2 ] ]
      },
      "furniture": { "%": "f_rubble_rock", "C": "f_coffin_c" },
      "mapping": { "%": { "item": [ { "item": "rock", "repeat": [ 5, 10 ] } ] } },
      "items": {
        "C": [ { "item": "cleansing_flame_casualties_old", "chance": 100 } ],
        "a": [ { "item": "curious_structure_tomb_offerings", "chance": 90 } ]
      },
      "place_loot": [
        { "group": "cleansing_flame_casualties_old", "x": 8, "y": 12 },
        { "item": "splinter", "x": 8, "y": 12, "chance": 50, "repeat": 20 },
        { "group": "curious_structure_tomb_offerings", "x": 9, "y": 12, "chance": 50, "repeat": 2 }
      ]
    }
  }
]
