[
  {
    "method": "json",
    "object": {
      "fill_ter": "t_dirt",
      "rows": [
        "~~~~~~~~~~~~~~~~~~~~~~~~",
        "~~~~~~~~~~~~~~~~~~~~~~~~",
        "~~~~~~~~~~~~~~~~~~~~~~~~",
        "~~~~~~~~~~~~~~~~~~~~~~~~",
        "~~~~~~~~~~~~~~~~~~~~~~~~",
        "~~~~~~~~~~~~~~~~~~~~~~~~",
        "~~~~~~~~~~~~~~~~~~~~~~~~",
        "~~~~~~~~~~~~~~~~~~~~~~~~",
        "________________________",
        "________________________",
        "________________________",
        "________________________",
        "........................",
        "........................",
        "........................",
        "........................",
        "........................",
        "........................",
        "........................",
        "........................",
        "........................",
        "........................",
        "........................",
        "........................"
      ],
      "palettes": [ "flesh_island_edge" ]
    },
    "om_terrain": [ "flesh_island_vfaraway_straight" ],
    "type": "mapgen",
    "weight": 69
  },
  {
    "method": "json",
    "object": {
      "fill_ter": "t_dirt",
      "rows": [
        "~~~~~~~~~~~~~~~~~~~~~~~~",
        "~~~~~~~~~~~~~~~~~~~~~~~~",
        "~~~~~~~~~~~~~~~~~~~~~~~~",
        "~~~~~~~~~~~~~~~~~~~~~~~~",
        "~~~~~~~~~~~~~~~~~~~~~~~~",
        "~~~~~~~~~_____~~~~~~~~~~",
        "~~~~~~__________~~~~~~~~",
        "~~~~______________~~~~~~",
        "_~__________________~~~_",
        "_________.....__________",
        "______..........________",
        "____..............______",
        "._..................___.",
        "........................",
        "........................",
        "........................",
        "........................",
        "........................",
        "........................",
        "........................",
        "........................",
        "........................",
        "........................",
        "........................"
      ],
      "palettes": [ "flesh_island_edge" ]
    },
    "om_terrain": [ "flesh_island_vfaraway_straight" ],
    "type": "mapgen",
    "weight": 1000
  },
  {
    "method": "json",
    "object": {
      "fill_ter": "t_dirt",
      "rows": [
        "~~~~~~~~~~~~~~~~~~~~~~~~",
        "~~~~~~~~~~~~~~~~~~~~~~~~",
        "~~~~~~~~~~~~~~~~~~~~~~~~",
        "~~~~~~~~~~~~~~~~~~~~~~~~",
        "~~~~~~~~~~~~~~~~~~~~~~~~",
        "~~~~~~~~~~~~~~~~~~~~~~~~",
        "~~~~~~~~~~~~~~~~~~~~~~~~",
        "~~~~~~~~~~~~~~~____~~__~",
        "___~~~~~~~~~~~__________",
        "_______~~~______________",
        "________________________",
        "_______________....__.._",
        "...___________..........",
        ".......___..............",
        "........................",
        "........................",
        "........................",
        "........................",
        "........................",
        "........................",
        "........................",
        "........................",
        "........................",
        "........................"
      ],
      "palettes": [ "flesh_island_edge" ]
    },
    "om_terrain": [ "flesh_island_vfaraway_straight" ],
    "type": "mapgen",
    "weight": 1000
  },
  {
    "method": "json",
    "object": {
      "fill_ter": "t_dirt",
      "rows": [
        "~~~~~~~~~~~~~~~~~~~~~~~~",
        "~~~~~~~~~~~~~~~~~~~~~~~~",
        "~~~~~~~~~~~~~~~~~~~~~~~~",
        "~~~~~~~~~~~~~~~~~~~~~~~~",
        "~~~~~~~~~~~~~~~~~~~~~~~~",
        "~~~~~~~~~~~~~~~~~~~~~~~~",
        "~~~~~~~~~~~~~~~~~~~~~~~~",
        "~~~~~~~~~~~~~~~~~~~~__~~",
        "_____~~~~~~~~~~~~~~_____",
        "___________~~~~~~~______",
        "______________~~________",
        "____________________..__",
        ".....______________.....",
        "..........._______......",
        "..............__........",
        "........................",
        "........................",
        "........................",
        "........................",
        "........................",
        "........................",
        "........................",
        "........................",
        "........................"
      ],
      "palettes": [ "flesh_island_edge" ]
    },
    "om_terrain": [ "flesh_island_vfaraway_straight" ],
    "type": "mapgen",
    "weight": 1000
  },
  {
    "method": "json",
    "object": {
      "fill_ter": "t_dirt",
      "rows": [
        "~~~~~~~~~~~~~~~~~~~~~~~~",
        "~~~~~~~~~~~~~~~~~~~~~~~~",
        "~~~~~~~~~~~~~~~~~~~~~~~~",
        "~~~~~~~~~~~~~~~~~~~~~~~~",
        "~~~~~~~~~~~~~~~~~~~~~~~~",
        "~~~~~~~~~~~~~~~~~~~~~~~~",
        "~~~~~~~~~~~~~~~~~~~~~~~~",
        "~~~~~~~~~~~~~~~~~~~~~~~~",
        "~~~~~~~~________________",
        "~~~~~~~~________________",
        "~~~~~~~~________________",
        "~~~~~~~~________________",
        "~~~~~~~~____............",
        "~~~~~~~~____............",
        "~~~~~~~~____............",
        "~~~~~~~~____............",
        "~~~~~~~~____............",
        "~~~~~~~~____............",
        "~~~~~~~~____............",
        "~~~~~~~~____............",
        "~~~~~~~~____............",
        "~~~~~~~~____............",
        "~~~~~~~~____............",
        "~~~~~~~~____............"
      ],
      "palettes": [ "flesh_island_edge" ]
    },
    "om_terrain": [ "flesh_island_vfaraway_vortex" ],
    "type": "mapgen",
    "weight": 69
  },
  {
    "method": "json",
    "object": {
      "fill_ter": "t_dirt",
      "rows": [
        "~~~~~~~~~~~~~~~~~~~~~~~~",
        "~~~~~~~~~~~~~~~~~~~~~~~~",
        "~~~~~~~~~~~~~~~~~~~~~~~~",
        "~~~~~~~~~~~~~~~~~~~~~~~~",
        "~~~~~~~~~~~~~~~~~~~~~~~~",
        "~~~~~~~~~~~~~~~~~~~~~~~~",
        "~~~~~~~~~~~~~~~~~~~~~~~~",
        "~~~~~~~~~~~~~~~~~~~___~~",
        "~~~~~~~~~~~~~~~~~_______",
        "~~~~~~~~~~~~~~~_________",
        "~~~~~~~~~~~~~~__________",
        "~~~~~~~~~~~~~~_____...__",
        "~~~~~~~~~~~~~____.......",
        "~~~~~~~~~~~~____........",
        "~~~~~~~~~~~~____........",
        "~~~~~~~~~~~____.........",
        "~~~~~~~~~~~____.........",
        "~~~~~~~~~~____..........",
        "~~~~~~~~~~____..........",
        "~~~~~~~~~~____..........",
        "~~~~~~~~~~____..........",
        "~~~~~~~~~____...........",
        "~~~~~~~~~____...........",
        "~~~~~~~~____............"
      ],
      "palettes": [ "flesh_island_edge" ]
    },
    "om_terrain": [ "flesh_island_vfaraway_vortex" ],
    "type": "mapgen",
    "weight": 1000
  },
  {
    "method": "json",
    "object": {
      "fill_ter": "t_dirt",
      "rows": [
        "~~~~~~~~~~~~~~~~~~~~~~~~",
        "~~~~~~~~~~~~~~~~~~~~~~~~",
        "~~~~~~~~~~~~~~~~~~~~~~~~",
        "~~~~~~~~~~~~~~~~~~~~~~~~",
        "~~~~~~~~~~~~~~~~~~~~~~~~",
        "~~~~~~~~~~~~~~~~~__~~~~~",
        "~~~~~~~~~~~~~~~_______~~",
        "~~~~~~~~~~~~~__________~",
        "~~~~~~~~~~~_____________",
        "~~~~~~~~~~_______.._____",
        "~~~~~~~~~______.......__",
        "~~~~~~~~~____.........._",
        "~~~~~~~~____............",
        "~~~~~~~____.............",
        "~~~~~~~____.............",
        "~~~~~~____..............",
        "~~~~~~____..............",
        "~~~~~~____..............",
        "~~~~~~~____.............",
        "~~~~~~~____.............",
        "~~~~~~~____.............",
        "~~~~~~~____.............",
        "~~~~~~~~____............",
        "~~~~~~~~____............"
      ],
      "palettes": [ "flesh_island_edge" ]
    },
    "om_terrain": [ "flesh_island_vfaraway_vortex" ],
    "type": "mapgen",
    "weight": 1000
  },
  {
    "method": "json",
    "object": {
      "fill_ter": "t_dirt",
      "rows": [
        "~~~~~~~~~~~~~~~~~~~~~~~~",
        "~~~~~~~~~~~~~~~~~~~~~~~~",
        "~~~~~~~~~~~~~~~~~~~~~~~~",
        "~~~~~~~~~~~~~~~~~~~~~~~~",
        "~~~~~~~~~~~~~~~~~~~~~~~~",
        "~~~~~~~~~~~~~~~~~~~~~~~~",
        "~~~~~~~~~~~~~~____~~~~~~",
        "~~~~~~~~~~~~_________~~~",
        "~~~~~~~~~~~_____________",
        "~~~~~~~~~_______________",
        "~~~~~~~~______....______",
        "~~~~~~~____..........___",
        "~~~~~~~____.............",
        "~~~~~~____..............",
        "~~~~~____...............",
        "~~~~~____...............",
        "~~~~____................",
        "~~~~____................",
        "~~~~____................",
        "~~~~~____...............",
        "~~~~~~____..............",
        "~~~~~~____..............",
        "~~~~~~~____.............",
        "~~~~~~~~____............"
      ],
      "palettes": [ "flesh_island_edge" ]
    },
    "om_terrain": [ "flesh_island_vfaraway_vortex" ],
    "type": "mapgen",
    "weight": 1000
  },
  {
    "method": "json",
    "object": {
      "fill_ter": "t_dirt",
      "rows": [
        "~~~~~~~~____............",
        "~~~~~~~~____............",
        "~~~~~~~~____............",
        "~~~~~~~~____............",
        "~~~~~~~~____............",
        "~~~~~~~~____............",
        "~~~~~~~~____............",
        "~~~~~~~~____............",
        "____________............",
        "____________............",
        "____________............",
        "____________............",
        "........................",
        "........................",
        "........................",
        "........................",
        "........................",
        "........................",
        "........................",
        "........................",
        "........................",
        "........................",
        "........................",
        "........................"
      ],
      "palettes": [ "flesh_island_edge" ]
    },
    "om_terrain": [ "flesh_island_vfaraway_curve" ],
    "type": "mapgen",
    "weight": 69
  },
  {
    "method": "json",
    "object": {
      "fill_ter": "t_dirt",
      "rows": [
        "~~~~~~~~~____...........",
        "~~~~~~~~~~____..........",
        "~~~~~~~~~~____..........",
        "~~~~~~~~~~____..........",
        "~~~~~~~~~~~____.........",
        "~~~~~~~~~~~____.........",
        "~~~~~~~~~~____..........",
        "~~~~~~~~~~____..........",
        "__~~~~~~~____...........",
        "____~~~~~~____..........",
        "______~~~~~____.........",
        "_________~____..........",
        "..____________..........",
        "....__________..........",
        "......_______...........",
        ".........___............",
        "........................",
        "........................",
        "........................",
        "........................",
        "........................",
        "........................",
        "........................",
        "........................"
      ],
      "palettes": [ "flesh_island_edge" ]
    },
    "om_terrain": [ "flesh_island_vfaraway_curve" ],
    "type": "mapgen",
    "weight": 1000
  },
  {
    "method": "json",
    "object": {
      "fill_ter": "t_dirt",
      "rows": [
        "~~~~~~~~____............",
        "~~~~~~~~~____...........",
        "~~~~~~~~~____...........",
        "~~~~~~~~~~____..........",
        "~~~~~~~~~~____..........",
        "~~~~~~~~~~____..........",
        "~~_~~~~~~~____..........",
        "____~~~~~~~____.........",
        "_____~~~~~~____.........",
        "______~~~_____..........",
        "__.._________...........",
        "....._______............",
        ".....______.............",
        "......___...............",
        "........................",
        "........................",
        "........................",
        "........................",
        "........................",
        "........................",
        "........................",
        "........................",
        "........................",
        "........................"
      ],
      "palettes": [ "flesh_island_edge" ]
    },
    "om_terrain": [ "flesh_island_vfaraway_curve" ],
    "type": "mapgen",
    "weight": 1000
  },
  {
    "method": "json",
    "object": {
      "fill_ter": "t_dirt",
      "rows": [
        "~~~~~~~~____............",
        "~~~~~~~~~____...........",
        "~~~~~~~~~~____..........",
        "~~~~~~~~~~____..........",
        "~~~~~~~~~~~____.........",
        "~~~~~~~~~~____..........",
        "~~~~~~~~~~____..........",
        "~~~~~~~~~____...........",
        "~~~~~~~~~___............",
        "_~~~~~~~___.............",
        "____~~_____.............",
        "__________..............",
        "_________...............",
        "._______................",
        "....__..................",
        "........................",
        "........................",
        "........................",
        "........................",
        "........................",
        "........................",
        "........................",
        "........................",
        "........................"
      ],
      "palettes": [ "flesh_island_edge" ]
    },
    "om_terrain": [ "flesh_island_vfaraway_curve" ],
    "type": "mapgen",
    "weight": 1000
  },
  {
    "type": "palette",
    "id": "flesh_island_edge",
    "terrain": {
      ".": [
        [ "t_secro_dirt_flesh", 250 ],
        [ "t_dirt", 1000 ],
        [ "t_secro_grass_flesh", 150 ],
        [ "t_grass", 600 ],
        [ "t_secro_grass_long_flesh", 75 ],
        [ "t_grass_long", 300 ],
        [ "t_secro_grass_tall_flesh", 25 ],
        [ "t_grass_tall", 100 ],
        [ "t_secro_shrub_flesh", 10 ],
        [ "t_shrub", 40 ],
        [ "t_secro_tree_young_flesh", 5 ],
        [ "t_tree_young", 20 ],
        [ "t_secro_tree_flesh", 2 ],
        [ "t_tree", 8 ],
        [ "t_tree_walnut", 8 ],
        [ "t_tree_blackjack", 8 ],
        [ "t_tree_chestnut", 8 ],
        [ "t_tree_beech", 8 ],
        [ "t_tree_hazelnut", 8 ],
        [ "t_tree_cottonwood", 8 ],
        [ "t_tree_elm", 8 ],
        [ "t_tree_apple", 8 ],
        [ "t_tree_pear", 8 ],
        [ "t_tree_coffee", 8 ],
        [ "t_tree_cherry", 8 ],
        [ "t_tree_juniper", 8 ],
        [ "t_tree_peach", 8 ],
        [ "t_tree_apricot", 8 ],
        [ "t_tree_plum", 8 ],
        [ "t_tree_mulberry", 8 ],
        [ "t_tree_elderberry", 8 ],
        [ "t_tree_pine", 8 ],
        [ "t_tree_birch", 8 ],
        [ "t_tree_willow", 8 ],
        [ "t_tree_maple", 8 ],
        [ "t_tree_hickory", 8 ]
      ],
      "_": "t_water_sh",
      "~": "t_water_dp"
    },
    "furniture": {
      ".": [
        [ "f_null", 8000 ],
        [ "f_secro_flower_flesh", 50 ],
        [ "f_secro_veinstalk", 25 ],
        [ "f_dandelion", 200 ],
        [ "f_chamomile", 200 ],
        [ "f_flower_tulip", 200 ],
        [ "f_flower_spurge", 200 ],
        [ "f_black_eyed_susan", 200 ],
        [ "f_lily", 200 ],
        [ "f_bluebell", 200 ],
        [ "f_dahlia", 200 ],
        [ "f_datura", 200 ],
        [ "f_secro_flesh_gas_emitter", 2 ],
        [ "f_secro_boulder_small_flesh", 5 ],
        [ "f_boulder_small", 20 ],
        [ "f_secro_boulder_medium_flesh", 2 ],
        [ "f_boulder_medium", 8 ],
        [ "f_secro_tree_flesh_atk", 25 ],
        [ "f_secro_boulder_large_flesh", 4 ],
        [ "f_boulder_large", 4 ]
      ]
    }
  }
]
