[
  {
	"//":"TODO spawn for q and maybe more",
    "type": "mapgen",
    "method": "json",
    "om_terrain": [[ "fk_base_1","fk_base_2" ]],
    "weight": 100,
    "object": {
      "faction_owner": [
        { "id": "flame_knuckle", "x": [ 0, 23 ], "y": [ 0, 23 ] },
        { "id": "flame_knuckle", "x": [ 24, 47 ], "y": [ 0, 23 ] }
      ],
      "predecessor_mapgen": "forest",
      "rows": [
		"          ,                                     ",
		"          ,     ##1#####1####1##                ",
		"          ,     #qqqq#dd_CCCCdd#                ",
		"          ,     1____#6_______61                ",
		" ,,,,,,,,,,     #q__B#dd_____dd#                ",
		" ,        ,     #w__B#6________#                ",
		" ,        ,     1w__B#dd_d_d_d_1                ",
		" ,        ,     #w__q#___d6d6d_#                ",
		" ,    ##o#+#o######x##+#######+#                ",
		" ,    #_______CC#qq_u#__#bb~R#u#                ",
		" ,    #_________#q___#__+~~~R###                ",
		" ,    #_t==t==t_x____x__#s4~v#u#                ",
		" ,    o_=======_#___u#__######+#                ",
		" ,    #_=======_#___u#__wwwwww_#                ",
		" ,    #_P==P==P_#q__u#_________#                ",
		" ,    #_________######_wwwwwww_1                ",
		" ,    o_________#r#_9#_________#                ",
		" ,    #$$$?_---_#_#+##_wwwwwww_#                ",
		" ,,,, #555$_e-e_+___u#_________#                ",
		" ,  , #555$_---_#_#+##_wwwwwww_1                ",
		" ,  , #555$_____#r#_9#_________#                ",
		"|+| , ##o####o#+#######1####1###                ",
		"|T| ,        ,                                  ",
		"||| ,,,,,,,,,,                                  "
      ],
      "place_zones": [
        { "type": "NPC_INVESTIGATE_ONLY", "faction": "flame_knuckle", "x": [ 16, 23 ], "y": [ 1, 15 ] },
        { "type": "NPC_INVESTIGATE_ONLY", "faction": "flame_knuckle", "x": [ 24, 31 ], "y": [ 1, 21 ] }
	  ],
      "terrain": {
        "_": "t_floor",
        "5": "t_floor",
        "C": "t_floor",
        "q": "t_floor",
        "w": "t_floor",
        "r": "t_floor",
        "9": "t_floor",
        "u": "t_floor",
        "B": "t_floor",
        "d": "t_floor",
        "6": "t_floor",
		"1": "t_reinforced_glass_shutter",
        "$": "t_fence_rope",
		"#": "t_concrete_wall",
		"|": "t_wall_log",
		"x": "t_door_locked_interior",
		"+": "t_door_c",
		"o": "t_window_domestic",
		"?": "t_chainfence_posts",
		",": "t_dirt",
        "=": "t_carpet_green",
        "E": "t_carpet_green",
        "t": "t_carpet_green",
        "P": "t_carpet_green",
        "-": "t_carpet_red",
        "e": "t_carpet_red",
        "~": "t_carpet_purple",
        "b": "t_carpet_purple",
        "s": "t_carpet_purple",
        "4": "t_carpet_purple",
		"T":"t_pit_covered"
	  },
	  "furniture": {
		"6": "f_dresser",
		"s": "f_desk",
		"v": "f_safe_l",
		"b": "f_bed",
		"C": "f_locker",
		"u": "f_locker",
		"q": "f_utility_shelf",
		"r": "f_utility_shelf",
        "5": "f_canvas_floor",
        "R": "f_bookcase",
        "4": "f_chair",
		"w": "f_rack_wood",
		"9": "f_shower",
		"d": "f_bunkbed",
		"P": "f_punching_bag",
		"E": "f_exercise",
        "t": [ "f_treadmill", "f_treadmill_mechanical" ],
        "e": [ "f_ergometer", "f_ergometer_mechanical" ]
	  },
	  "items":{
		"B":[ 
			{ "item": "keg_wine_intact", "chance": 50 },
			{ "item": "keg_beer", "chance": 50 }
		],
		"6": [
			{ "item": "SUS_dresser_mens", "chance": 50, "repeat": [ 1, 2 ] },
			{ "item": "SUS_dresser_womens", "chance": 50, "repeat": [ 1, 2 ] }
		],
        "C": { "item": "allclothes", "chance": 90, "repeat": [ 1, 5 ] },
        "u": { "item": "cleaning", "chance": 80, "repeat": [ 1, 3 ] },
        "r": { "item": "shower", "chance": 80, "repeat": [ 1, 3 ] },
        "w": [ { "item": "cannedfood", "chance": 80, "repeat": [ 2, 8 ] }, { "item": "snacks", "chance": 25, "repeat": [ 1, 3 ] } ],
        "q": [
          { "item": "pasta", "chance": 80, "repeat": [ 2, 8 ] },
          { "item": "kitchen", "chance": 50, "repeat": [ 1, 3 ] },
          { "item": "snacks", "chance": 25, "repeat": [ 1, 3 ] }
        ]
	  },
	  "place_terrain": [ { "ter": "t_stairs_down", "x": 28, "y": 10 } ],
      "place_npcs": [
	    { "class": "flame_knuckle_apprentice", "x": 20, "y": 3 },
	    { "class": "flame_knuckle_master", "x": 23, "y": 9 },
	    { "class": "flame_knuckle_elite", "x": 11, "y": 10 },
	    { "class": "flame_knuckle_apprentice", "x": 8, "y": 11 },
	    { "class": "flame_knuckle_apprentice", "x": 11, "y": 11 },
	    { "class": "flame_knuckle_master", "x": 23, "y": 11 },
	    { "class": "flame_knuckle_apprentice_door", "x": 15, "y": 12 },
	    { "class": "flame_knuckle_apprentice", "x": 8, "y": 13 },
	    { "class": "flame_knuckle_apprentice", "x": 14, "y": 13 },
	    { "class": "flame_knuckle_apprentice", "x": 22, "y": 13 },
	    { "class": "flame_knuckle_apprentice", "x": 18, "y": 14 },
	    { "class": "flame_knuckle_elite", "x": 11, "y": 17 },
	    { "class": "flame_knuckle_apprentice", "x": 9, "y": 18 },
	    { "class": "flame_knuckle_apprentice", "x": 7, "y": 20 },
	    { "class": "flame_knuckle_elite", "x": 20, "y": 20 },
	    { "class": "flame_knuckle_apprentice", "x": 30, "y": 20 }
      ]
    }
  },
  {
	"//":"TODO edit to make roof cooler",
    "type": "mapgen",
    "method": "json",
    "om_terrain": [[ "fk_base_roof_1","fk_base_roof_2" ]],
    "object": {
      "fill_ter": "t_open_air",
      "rows": [
	  	"                                                ",
	  	"                ................                ",
	  	"                ................                ",
	  	"                ................                ",
	  	"                ................                ",
	  	"                ................                ",
	  	"                ................                ",
	  	"                ................                ",
	  	"      ..........................                ",		
	  	"      ..........................                ",		
	  	"      ..........................                ",		
	  	"      ..........................                ",		
	  	"      ..........................                ",		
	  	"      ..........................                ",		
	  	"      ..........................                ",		
	  	"      ..........................                ",		
	  	"      ..........................                ",		
	  	"      ..........................                ",		
	  	"      ..........................                ",		
	  	"      ..........................                ",		
	  	"      ..........................                ",		
	  	"      ..........................                ",		
	  	"...   ..........................                ",		
	  	"...                                             ",
	  	"...                                             "
		
      ],
      "palettes": [ "roof_palette" ]
    }
  },
  {
    "type": "mapgen",
    "method": "json",
    "om_terrain": "fk_base_stash",
    "weight": 250,
    "object": {
      "fill_ter": "t_rock",
      "rows": [
        " |--|                   ",
        "|-qq|                   ",
        "|<..|                   ",
        "|-qq|                   ",
        " |--|                   ",
        "                        ",
        "                        ",
        "                        ",
        "                        ",
        "                        ",
        "                        ",
        "                        ",
        "                        ",
        "                        ",
        "                        ",
        "                        ",
        "                        ",
        "                        ",
        "                        ",
        "                        ",
        "                        ",
        "                        ",
        "                        ",
        "                        "		
      ],
      "terrain": {
        "-": "t_wall",
        ".": "t_rock_floor",
        "<": "t_stairs_up",
        "|": "t_wall"
      },
	  "furniture":{"q": "f_utility_shelf"}
    }
  }
]