[
  {
    "type": "mapgen",
    "om_terrain": [ "morlock_village_edge_b" ],
    "method": "json",
    "weight": 1000,
    "object": {
      "fill_ter": "t_rock_floor",
      "rows": [
        "########################",
        "########################",
        "########################",
        "########################",
        "########################",
        "########################",
        "########################",
        "########################",
        "########################",
        "########################",
        "########################",
        "########################",
        "########################",
        "########################",
        "########################",
        "########################",
        "######..................",
        "######..................",
        "======..========+====###",
        "=l..l=..+....d=U..RR=###",
        "==+===..=..@.B=U....====",
        "...+....=bb..B=NOC..+...",
        "..A=....=============...",
        "..A=##..############=..."
      ],
      "rotation": 0,
      "palettes": [ "morlock_village" ]
    }
  },
  {
    "type": "mapgen",
    "om_terrain": [ "morlock_village_edge_b" ],
    "method": "json",
    "weight": 1000,
    "object": {
      "fill_ter": "t_rock_floor",
      "rows": [
        "########################",
        "########################",
        "########################",
        "########################",
        "########################",
        "########################",
        "########################",
        "########################",
        "########################",
        "########################",
        "########################",
        "########################",
        "########################",
        "########################",
        "########################",
        "########################",
        "###########.............",
        "###########.............",
        "###########..=====+==+==",
        "###########..=BB=T..=.l=",
        "======#####..=H.=...=.l=",
        "...+.+.......=d.+.aa=..@",
        "..H===.......========...",
        "..@=##..############=..."
      ],
      "rotation": 0,
      "palettes": [ "morlock_village" ]
    }
  },
  {
    "type": "mapgen",
    "om_terrain": [ "morlock_village_edge_b" ],
    "method": "json",
    "weight": 1000,
    "object": {
      "fill_ter": "t_rock_floor",
      "rows": [
        "########################",
        "########################",
        "########################",
        "########################",
        "########################",
        "########################",
        "########################",
        "########################",
        "########################",
        "########################",
        "########################",
        "########################",
        "########################",
        "########################",
        "##H....#################",
        "#........############..H",
        "#...##.....#########....",
        "#...####....######......",
        "##...####....####.....##",
        "###...####...###....####",
        "====..#####........#====",
        ".TT=...#####......##=BB.",
        "cTT=#...#####H..####=d..",
        ".c.=##..H###########=BB."
      ],
      "rotation": 0,
      "palettes": [ "morlock_village" ]
    }
  },
  {
    "type": "mapgen",
    "om_terrain": [ "morlock_village_edge_b" ],
    "method": "json",
    "weight": 500,
    "object": {
      "fill_ter": "t_rock_floor",
      "rows": [
        "########################",
        "########################",
        "########################",
        "#########,,M,,##########",
        "######,,M,,,,M,M,M######",
        "#####,M,,,M,,,,,,,~#####",
        "####~,,,,m,m,m,m,,,M####",
        "####,M,,,m,m,m,m,,,,####",
        "####M,,M,m,m,m,m,,M,####",
        "####,,,,,m,m,m,m,,,,####",
        "####M,M,,m,m,m,m,,,M####",
        "####,,,,,m,m,m,m,M,,####",
        "####,M,,,m,m,m,m,,,,####",
        "####,,,,,m,m,m,m,,M,####",
        "##~,M,,,,m,m,m,m,,,,M###",
        "##M,,,M,,,,,,,,,,,M,,M##",
        "#=======+==.............",
        "#=.BBd=l.l=.............",
        "#=....+..4=..=====+==+==",
        "#=N.Tc=COC=..=BB=T..=..=",
        "===========..=H.=...=.l=",
        ".....+.......=d.+.aa=...",
        "..H===.......========...",
        "...=##..############=..."
      ],
      "rotation": 0,
      "palettes": [ "morlock_village" ],
      "terrain": { ",": "t_dirt" }
    }
  },
  {
    "type": "mapgen",
    "om_terrain": [ "morlock_village_edge_b" ],
    "method": "json",
    "weight": 500,
    "object": {
      "fill_ter": "t_rock_floor",
      "rows": [
        "########################",
        "########################",
        "########################",
        "########################",
        "########################",
        "########################",
        "....+.,,,,,,,,,,,,.+....",
        "....+.,,,,,,,,,,,,.+....",
        "##..##x,,,,,,,,,,~##..##",
        "##..##,,,,,,,,,,,~##..##",
        "##..##x,,,,,,P,,,~##..##",
        "##..##,,,P,,,,,,,~##..##",
        "##..##,,,,,,,,,,,~##..##",
        "##..##x,,,P,,P,,,~##..##",
        "##..##,,,,,,,,,,,~##..##",
        "##..##x,,,,,,,,,,~##..##",
        "##..+.,,,,,,,,,,,,.+....",
        "##..+.,,,,,,,,,,,,.+....",
        "##..##################H#",
        "##..####################",
        "==......H###########====",
        ".=......############=DDD",
        ".===##..############=.c.",
        "..b=##..############=..."
      ],
      "rotation": 0,
      "palettes": [ "morlock_village" ],
      "terrain": { "P": "t_dirt", ",": "t_dirt" },
      "monster": { "P": [ { "monster": "mon_pig_mutant_cave" } ] }
    }
  },
  {
    "type": "mapgen",
    "om_terrain": [ "morlock_village_edge_b" ],
    "method": "json",
    "weight": 1000,
    "object": {
      "fill_ter": "t_rock_floor",
      "rows": [
        "########################",
        "########################",
        "########################",
        "########################",
        "########################",
        "########################",
        "########################",
        "########################",
        "########################",
        "########################",
        "########################",
        "###############....#####",
        "#############.......####",
        "###########..........###",
        "#########......##.....##",
        "########.....#####....##",
        "########......#####.....",
        "##########....######....",
        "###########.....######.#",
        "#############....#######",
        "====#######.......###===",
        ".TT=###.........#####=..",
        "cTT=##.......#######==..",
        ".c.=##..############=BB."
      ],
      "rotation": 0,
      "palettes": [ "morlock_village" ]
    }
  }
]
