[
  {
    "type": "mapgen",
    "method": "json",
    "om_terrain": [ "ninja_blaze_trailer_home" ],
    "weight": 100,
    "object": {
      "fill_ter": "t_dirt",
      "rows": [
        "                        ",
        "                    w   ",
        "w   ============        ",
        "    =          =        ",
        "    =          =        ",
        " w  =          =        ",
        "    =          =        ",
        "    =          =        ",
        "    =          =        ",
        "    ===T...=====        ",
        "        ...@            ",
        "        ...             ",
        "        ...             ",
        "        ...ww           ",
        "        ...ww           ",
        "........................",
        "........................",
        "........................",
        "                    . w ",
        "                    . 4 ",
        "  w                w.Pw ",
        "         w        w4 ~4 ",
        " w                 ww w ",
        "                    4w  "
      ],
      "terrain": {
        " ": [ "t_grass", "t_grass", "t_grass", "t_grass", "t_grass", "t_grass", "t_dirt" ],
        ".": "t_dirt",
        "4": "t_tree_willow",
        "@": "t_dirt",
        "P": "t_water_pump",
        "w": "t_shrub",
        "~": "t_water_sh"
      },
      "traps": { "=": "tr_beartrap" },
      "signs": { "T": { "snippet": "ninja_snippet_blaze_home" } },
      "npcs": { "@": { "class": "ninja_npc_high_ninja_blaze" } },
      "place_vehicles": [
        { "vehicle": "ninja_vehicle_house_trailer", "x": 10, "y": 5, "chance": 100, "rotation": 180 },
        { "vehicle": "ninja_vehicle_ninja_ZX14_custom", "x": 4, "y": 15, "chance": 20, "rotation": 90 }
      ]
    }
  }
]
