[
  {
    "type": "palette",
    "id": "wiz_shack",
    "terrain": {
      "+": "t_door_c",
      "3": "t_door_locked",
      "2": "t_door_metal_c",
      "4": "t_door_metal_pickable",
      "5": "t_door_metal_locked",
      "[": "t_door_glass_c",
      "-": "t_wall",
      "|": "t_concrete_wall",
      "/": "t_wall_wood",
      "=": "t_wall_glass",
      "(": "t_reinforced_glass",
      " ": [ "t_grass", "t_grass", "t_grass", "t_dirt", "t_dirt" ],
      "s": "t_sidewalk",
      "g": "t_bridge",
      "_": "t_pavement",
      "y": "t_pavement_y",
      "`": "t_hole",
      ".": "t_floor",
      "<": "t_stairs_up",
      ">": "t_stairs_down",
      "0": "t_window_empty",
      ":": "t_window_domestic",
      "u": "t_chainfence_h",
      "U": "t_chainfence_v",
      "#": "t_shrub"
    },
    "furniture": {
      "&": "f_toilet",
      "-": "f_table",
      "~": "f_shower",
      "@": "f_bed",
      "a": "f_armchair",
      "k": "f_cupboard",
      "D": "f_dresser",
      "h": "f_chair",
      "b": "f_floor_lamp",
      "B": "f_bookcase",
      "c": "f_counter",
      "l": "f_huge_mana_crystal",
      "n": "f_trashcan",
      "d": "f_desk",
      "f": "f_fridge",
      "F": "f_glass_fridge",
      "o": "f_oven",
      "O": "f_woodstove",
      "i": "f_sink",
      "p": "f_pool_table",
      "r": "f_rack",
      "?": "f_sofa",
      "t": "f_table",
      "^": "f_indoor_plant",
      "x": "f_safe_l"
    }
  },
  {
    "type": "palette",
    "id": "wiz_roof",
    "terrain": { ".": "t_flat_roof" }
  },
  {
    "type": "mapgen",
    "method": "json",
    "om_terrain": [ "wiz_shack" ],
    "//": "Ground level - Z-0.",
    "weight": 100,
    "object": {
      "faction_owner": [ { "id": "wizards_ancient", "x": [ 0, 23 ], "y": [ 0, 23 ] } ],
      "fill_ter": "t_floor",
      "rows": [
        "                        ",
        "                        ",
        "                        ",
        "                        ",
        "                        ",
        "                        ",
        "   ////::://///://://   ",
        "   /....a...b/@./~.&/   ",
        "   /........t/@./i../   ",
        "   /b.......-//+//+//   ",
        "   /.....l........../   ",
        "   :...............b/   ",
        "   /r...........tt.o:   ",
        "   /r..............k/   ",
        "   /r....b....bfnick/   ",
        "   ///:////++///:////   ",
        "                        ",
        "                        ",
        "                        ",
        "                        ",
        "                        ",
        "                        ",
        "                        ",
        "                        "
      ],
      "palettes": [ "wiz_shack" ],
      "items": {
        "r": { "item": "spellbook_loot_0", "chance": 100, "repeat": [ 2, 5 ] },
        "k": [
          { "item": "dry_goods", "chance": 100, "repeat": [ 2, 5 ] },
          { "item": "preserved_food", "chance": 100, "repeat": [ 4, 8 ] },
          { "item": "pantry", "chance": 100, "repeat": [ 4, 8 ] }
        ],
        "f": [
          { "item": "barbecue", "chance": 70, "repeat": [ 2, 5 ] },
          { "item": "fridgesnacks", "chance": 100, "repeat": [ 4, 8 ] }
        ]
      },
      "place_npcs": [ { "class": "magus_old", "x": 10, "y": 13 } ]
    }
  },
  {
    "type": "mapgen",
    "method": "json",
    "om_terrain": [ "wiz_shack" ],
    "//": "Ground level - Z-0.",
    "weight": 100,
    "object": {
      "faction_owner": [ { "id": "wizards_ancient", "x": [ 0, 23 ], "y": [ 0, 23 ] } ],
      "fill_ter": "t_floor",
      "rows": [
        "                        ",
        "                        ",
        "                        ",
        "                        ",
        "                        ",
        "                        ",
        "   ////::://///://://   ",
        "   /....a...b/@./~.&/   ",
        "   /........t/@./i../   ",
        "   /b.......-//+//+//   ",
        "   /.....l........../   ",
        "   :...............b/   ",
        "   /r...........tt.o:   ",
        "   /r..............k/   ",
        "   /r....b....bfnick/   ",
        "   ///:////++///:////   ",
        "                        ",
        "                        ",
        "                        ",
        "                        ",
        "                        ",
        "                        ",
        "                        ",
        "                        "
      ],
      "palettes": [ "wiz_shack" ],
      "items": {
        "r": { "item": "spellbook_loot_0", "chance": 100, "repeat": [ 2, 5 ] },
        "k": [
          { "item": "dry_goods", "chance": 100, "repeat": [ 2, 5 ] },
          { "item": "preserved_food", "chance": 100, "repeat": [ 4, 8 ] },
          { "item": "pantry", "chance": 100, "repeat": [ 4, 8 ] }
        ],
        "f": [
          { "item": "barbecue", "chance": 70, "repeat": [ 2, 5 ] },
          { "item": "fridgesnacks", "chance": 100, "repeat": [ 4, 8 ] }
        ]
      },
      "place_npcs": [ { "class": "techno_kid", "x": 10, "y": 13 } ]
    }
  },
  {
    "type": "mapgen",
    "method": "json",
    "om_terrain": [ "wiz_shack" ],
    "//": "Ground level - Z-0.",
    "weight": 100,
    "object": {
      "faction_owner": [ { "id": "wizards_ancient", "x": [ 0, 23 ], "y": [ 0, 23 ] } ],
      "fill_ter": "t_floor",
      "rows": [
        "                        ",
        "                        ",
        "                        ",
        "                        ",
        "                        ",
        "                        ",
        "   ////::://///://://   ",
        "   /....a...b/@./~.&/   ",
        "   /........t/@./i../   ",
        "   /b.......-//+//+//   ",
        "   /.....l........../   ",
        "   :...............b/   ",
        "   /r...........tt.o:   ",
        "   /r..............k/   ",
        "   /r....b....bfnick/   ",
        "   ///:////++///:////   ",
        "                        ",
        "                        ",
        "                        ",
        "                        ",
        "                        ",
        "                        ",
        "                        ",
        "                        "
      ],
      "palettes": [ "wiz_shack" ],
      "items": {
        "r": { "item": "spellbook_loot_0", "chance": 100, "repeat": [ 2, 5 ] },
        "k": [
          { "item": "dry_goods", "chance": 100, "repeat": [ 2, 5 ] },
          { "item": "preserved_food", "chance": 100, "repeat": [ 4, 8 ] },
          { "item": "pantry", "chance": 100, "repeat": [ 4, 8 ] }
        ],
        "f": [
          { "item": "barbecue", "chance": 70, "repeat": [ 2, 5 ] },
          { "item": "fridgesnacks", "chance": 100, "repeat": [ 4, 8 ] }
        ]
      },
      "place_npcs": [ { "class": "healer_priest", "x": 10, "y": 13 } ]
    }
  },
  {
    "type": "mapgen",
    "method": "json",
    "om_terrain": [ "wiz_shack" ],
    "//": "Ground level - Z-0.",
    "weight": 100,
    "object": {
      "faction_owner": [ { "id": "wizards_ancient", "x": [ 0, 23 ], "y": [ 0, 23 ] } ],
      "fill_ter": "t_floor",
      "rows": [
        "                        ",
        "                        ",
        "                        ",
        "                        ",
        "                        ",
        "                        ",
        "   ////::://///://://   ",
        "   /....a...b/@./~.&/   ",
        "   /........t/@./i../   ",
        "   /b.......-//+//+//   ",
        "   /.....l........../   ",
        "   :...............b/   ",
        "   /r...........tt.o:   ",
        "   /r..............k/   ",
        "   /r....b....bfnick/   ",
        "   ///:////++///:////   ",
        "                        ",
        "                        ",
        "                        ",
        "                        ",
        "                        ",
        "                        ",
        "                        ",
        "                        "
      ],
      "palettes": [ "wiz_shack" ],
      "items": {
        "r": { "item": "spellbook_loot_0", "chance": 100, "repeat": [ 2, 5 ] },
        "k": [
          { "item": "dry_goods", "chance": 100, "repeat": [ 2, 5 ] },
          { "item": "preserved_food", "chance": 100, "repeat": [ 4, 8 ] },
          { "item": "pantry", "chance": 100, "repeat": [ 4, 8 ] }
        ],
        "f": [
          { "item": "barbecue", "chance": 70, "repeat": [ 2, 5 ] },
          { "item": "fridgesnacks", "chance": 100, "repeat": [ 4, 8 ] }
        ]
      },
      "place_npcs": [ { "class": "magus_old", "x": 10, "y": 13 } ]
    }
  },
  {
    "type": "mapgen",
    "method": "json",
    "om_terrain": [ "wiz_shack" ],
    "//": "Ground level - Z-0.",
    "weight": 100,
    "object": {
      "faction_owner": [ { "id": "wizards_ancient", "x": [ 0, 23 ], "y": [ 0, 23 ] } ],
      "fill_ter": "t_floor",
      "rows": [
        "                        ",
        "                        ",
        "                        ",
        "                        ",
        "                        ",
        "                        ",
        "   ////::://///://://   ",
        "   /....a...b/@./~.&/   ",
        "   /........t/@./i../   ",
        "   /b.......-//+//+//   ",
        "   /.....l........../   ",
        "   :...............b/   ",
        "   /r...........tt.o:   ",
        "   /r..............k/   ",
        "   /r....b....bfnick/   ",
        "   ///:////++///:////   ",
        "                        ",
        "                        ",
        "                        ",
        "                        ",
        "                        ",
        "                        ",
        "                        ",
        "                        "
      ],
      "palettes": [ "wiz_shack" ],
      "items": {
        "r": { "item": "spellbook_loot_0", "chance": 100, "repeat": [ 2, 5 ] },
        "k": [
          { "item": "dry_goods", "chance": 100, "repeat": [ 2, 5 ] },
          { "item": "preserved_food", "chance": 100, "repeat": [ 4, 8 ] },
          { "item": "pantry", "chance": 100, "repeat": [ 4, 8 ] }
        ],
        "f": [
          { "item": "barbecue", "chance": 70, "repeat": [ 2, 5 ] },
          { "item": "fridgesnacks", "chance": 100, "repeat": [ 4, 8 ] }
        ]
      },
      "place_npcs": [ { "class": "techno_kid", "x": 10, "y": 13 } ]
    }
  },
  {
    "type": "mapgen",
    "method": "json",
    "om_terrain": [ "wiz_shack" ],
    "//": "Ground level - Z-0.",
    "weight": 100,
    "object": {
      "faction_owner": [ { "id": "wizards_ancient", "x": [ 0, 23 ], "y": [ 0, 23 ] } ],
      "fill_ter": "t_floor",
      "rows": [
        "                        ",
        "                        ",
        "                        ",
        "                        ",
        "                        ",
        "                        ",
        "   ////::://///://://   ",
        "   /....a...b/@./~.&/   ",
        "   /........t/@./i../   ",
        "   /b.......-//+//+//   ",
        "   /.....l........../   ",
        "   :...............b/   ",
        "   /r...........tt.o:   ",
        "   /r..............k/   ",
        "   /r....b....bfnick/   ",
        "   ///:////++///:////   ",
        "                        ",
        "                        ",
        "                        ",
        "                        ",
        "                        ",
        "                        ",
        "                        ",
        "                        "
      ],
      "palettes": [ "wiz_shack" ],
      "items": {
        "r": { "item": "spellbook_loot_0", "chance": 100, "repeat": [ 2, 5 ] },
        "k": [
          { "item": "dry_goods", "chance": 100, "repeat": [ 2, 5 ] },
          { "item": "preserved_food", "chance": 100, "repeat": [ 4, 8 ] },
          { "item": "pantry", "chance": 100, "repeat": [ 4, 8 ] }
        ],
        "f": [
          { "item": "barbecue", "chance": 70, "repeat": [ 2, 5 ] },
          { "item": "fridgesnacks", "chance": 100, "repeat": [ 4, 8 ] }
        ]
      },
      "place_npcs": [ { "class": "healer_priest", "x": 10, "y": 13 } ]
    }
  },
  {
    "type": "mapgen",
    "method": "json",
    "om_terrain": [ "wiz_shack" ],
    "//": "Ground level - Z-0.",
    "weight": 100,
    "object": {
      "faction_owner": [ { "id": "wizards_ancient", "x": [ 0, 23 ], "y": [ 0, 23 ] } ],
      "fill_ter": "t_floor",
      "rows": [
        "                        ",
        "                        ",
        "                        ",
        "                        ",
        "                        ",
        "                        ",
        "   ////::://///://://   ",
        "   /....a...b/@./~.&/   ",
        "   /........t/@./i../   ",
        "   /b.......-//+//+//   ",
        "   /.....l........../   ",
        "   :...............b/   ",
        "   /r...........tt.o:   ",
        "   /r..............k/   ",
        "   /r....b....bfnick/   ",
        "   ///:////++///:////   ",
        "                        ",
        "                        ",
        "                        ",
        "                        ",
        "                        ",
        "                        ",
        "                        ",
        "                        "
      ],
      "palettes": [ "wiz_shack" ],
      "items": {
        "r": { "item": "spellbook_loot_0", "chance": 100, "repeat": [ 2, 5 ] },
        "k": [
          { "item": "dry_goods", "chance": 100, "repeat": [ 2, 5 ] },
          { "item": "preserved_food", "chance": 100, "repeat": [ 4, 8 ] },
          { "item": "pantry", "chance": 100, "repeat": [ 4, 8 ] }
        ],
        "f": [
          { "item": "barbecue", "chance": 70, "repeat": [ 2, 5 ] },
          { "item": "fridgesnacks", "chance": 100, "repeat": [ 4, 8 ] }
        ]
      },
      "place_npcs": [ { "class": "magus_old", "x": 10, "y": 13 } ]
    }
  },
  {
    "type": "mapgen",
    "method": "json",
    "om_terrain": [ "wiz_shack" ],
    "//": "Ground level - Z-0.",
    "weight": 100,
    "object": {
      "faction_owner": [ { "id": "wizards_ancient", "x": [ 0, 23 ], "y": [ 0, 23 ] } ],
      "fill_ter": "t_floor",
      "rows": [
        "                        ",
        "                        ",
        "                        ",
        "                        ",
        "                        ",
        "                        ",
        "   ////::://///://://   ",
        "   /....a...b/@./~.&/   ",
        "   /........t/@./i../   ",
        "   /b.......-//+//+//   ",
        "   /.....l........../   ",
        "   :...............b/   ",
        "   /r...........tt.o:   ",
        "   /r..............k/   ",
        "   /r....b....bfnick/   ",
        "   ///:////++///:////   ",
        "                        ",
        "                        ",
        "                        ",
        "                        ",
        "                        ",
        "                        ",
        "                        ",
        "                        "
      ],
      "palettes": [ "wiz_shack" ],
      "items": {
        "r": { "item": "spellbook_loot_0", "chance": 100, "repeat": [ 2, 5 ] },
        "k": [
          { "item": "dry_goods", "chance": 100, "repeat": [ 2, 5 ] },
          { "item": "preserved_food", "chance": 100, "repeat": [ 4, 8 ] },
          { "item": "pantry", "chance": 100, "repeat": [ 4, 8 ] }
        ],
        "f": [
          { "item": "barbecue", "chance": 70, "repeat": [ 2, 5 ] },
          { "item": "fridgesnacks", "chance": 100, "repeat": [ 4, 8 ] }
        ]
      },
      "place_npcs": [ { "class": "techno_kid", "x": 10, "y": 13 } ]
    }
  },
  {
    "type": "mapgen",
    "method": "json",
    "om_terrain": [ "wiz_roof" ],
    "weight": 100,
    "object": {
      "fill_ter": "t_open_air",
      "rows": [
        "                        ",
        "                        ",
        "                        ",
        "                        ",
        "                        ",
        "                        ",
        "   ..................   ",
        "   ..................   ",
        "   ..................   ",
        "   ..................   ",
        "   ..................   ",
        "   ..................   ",
        "   ..................   ",
        "   ..................   ",
        "   ..................   ",
        "   ..................   ",
        "                        ",
        "                        ",
        "                        ",
        "                        ",
        "                        ",
        "                        ",
        "                        ",
        "                        "
      ],
      "palettes": [ "wiz_roof" ]
    }
  }
]
